Time,Date,Day of the week,CarCount,BikeCount,BusCount,TruckCount,Total,Traffic Situation
12:00:00 AM,10,Tuesday,13,2,2,24,41,normal
12:15:00 AM,10,Tuesday,14,1,1,36,52,low
12:30:00 AM,10,Tuesday,10,2,2,32,46,normal
12:45:00 AM,10,Tuesday,10,2,2,36,50,normal
01:00:00 AM,10,Tuesday,11,2,1,34,48,normal
01:15:00 AM,10,Tuesday,15,1,1,39,56,low
01:30:00 AM,10,Tuesday,14,2,2,27,45,normal
01:45:00 AM,10,Tuesday,13,2,1,20,36,normal
02:00:00 AM,10,Tuesday,7,0,0,26,33,normal
02:15:00 AM,10,Tuesday,13,0,0,34,47,normal
02:30:00 AM,10,Tuesday,15,2,0,38,55,low
02:45:00 AM,10,Tuesday,5,2,0,37,44,normal
03:00:00 AM,10,Tuesday,9,1,0,34,44,normal
03:15:00 AM,10,Tuesday,8,0,2,35,45,normal
03:30:00 AM,10,Tuesday,7,0,0,34,41,normal
03:45:00 AM,10,Tuesday,10,1,2,38,51,low
04:00:00 AM,10,Tuesday,82,7,3,10,102,high
04:15:00 AM,10,Tuesday,71,3,0,30,104,high
04:30:00 AM,10,Tuesday,89,10,2,10,111,high
04:45:00 AM,10,Tuesday,77,3,0,18,98,low
05:00:00 AM,10,Tuesday,90,2,0,22,114,high
05:15:00 AM,10,Tuesday,84,1,7,23,115,high
05:30:00 AM,10,Tuesday,88,8,6,10,112,high
05:45:00 AM,10,Tuesday,97,27,15,8,147,high
06:00:00 AM,10,Tuesday,107,10,24,11,152,heavy
06:15:00 AM,10,Tuesday,82,26,11,5,124,high
06:30:00 AM,10,Tuesday,93,16,24,10,143,high
06:45:00 AM,10,Tuesday,128,18,14,6,166,heavy
07:00:00 AM,10,Tuesday,110,19,12,14,155,heavy
07:15:00 AM,10,Tuesday,122,13,10,5,150,high
07:30:00 AM,10,Tuesday,92,14,16,12,134,high
07:45:00 AM,10,Tuesday,143,30,17,12,202,heavy
08:00:00 AM,10,Tuesday,134,18,21,11,184,heavy
08:15:00 AM,10,Tuesday,134,30,15,14,193,heavy
08:30:00 AM,10,Tuesday,119,13,14,13,159,heavy
08:45:00 AM,10,Tuesday,139,12,22,13,186,heavy
09:00:00 AM,10,Tuesday,73,9,14,17,113,high
09:15:00 AM,10,Tuesday,33,12,9,6,60,low
09:30:00 AM,10,Tuesday,69,9,26,9,113,high
09:45:00 AM,10,Tuesday,69,12,10,5,96,low
10:00:00 AM,10,Tuesday,55,11,9,17,92,low
10:15:00 AM,10,Tuesday,32,7,27,12,78,low
10:30:00 AM,10,Tuesday,53,13,7,5,78,low
10:45:00 AM,10,Tuesday,34,10,9,35,88,low
11:00:00 AM,10,Tuesday,32,10,10,26,78,low
11:15:00 AM,10,Tuesday,47,10,5,25,87,low
11:30:00 AM,10,Tuesday,28,0,5,29,62,low
11:45:00 AM,10,Tuesday,35,7,13,34,89,low
12:00:00 PM,10,Tuesday,38,10,8,31,87,low
12:15:00 PM,10,Tuesday,32,3,12,35,82,low
12:30:00 PM,10,Tuesday,54,5,12,29,100,low
12:45:00 PM,10,Tuesday,52,2,12,29,95,low
01:00:00 PM,10,Tuesday,68,19,18,30,135,high
01:15:00 PM,10,Tuesday,73,15,3,17,108,high
01:30:00 PM,10,Tuesday,21,18,18,23,80,low
01:45:00 PM,10,Tuesday,63,11,16,11,101,high
02:00:00 PM,10,Tuesday,7,17,20,18,62,low
02:15:00 PM,10,Tuesday,76,15,32,17,140,high
02:30:00 PM,10,Tuesday,59,14,18,28,119,high
02:45:00 PM,10,Tuesday,90,9,3,14,116,high
03:00:00 PM,10,Tuesday,5,13,4,20,42,normal
03:15:00 PM,10,Tuesday,33,18,22,23,96,low
03:30:00 PM,10,Tuesday,39,19,13,23,94,low
03:45:00 PM,10,Tuesday,150,21,10,14,195,heavy
04:00:00 PM,10,Tuesday,126,27,40,19,212,heavy
04:15:00 PM,10,Tuesday,144,7,35,17,203,heavy
04:30:00 PM,10,Tuesday,145,13,12,18,188,heavy
04:45:00 PM,10,Tuesday,121,29,27,15,192,heavy
05:00:00 PM,10,Tuesday,150,21,37,19,227,heavy
05:15:00 PM,10,Tuesday,122,8,10,11,151,heavy
05:30:00 PM,10,Tuesday,129,20,35,18,202,heavy
05:45:00 PM,10,Tuesday,114,7,39,19,179,heavy
06:00:00 PM,10,Tuesday,109,10,26,17,162,heavy
06:15:00 PM,10,Tuesday,101,22,24,18,165,heavy
06:30:00 PM,10,Tuesday,91,13,8,12,124,high
06:45:00 PM,10,Tuesday,90,17,10,11,128,high
07:00:00 PM,10,Tuesday,107,2,15,35,159,heavy
07:15:00 PM,10,Tuesday,66,7,5,22,100,low
07:30:00 PM,10,Tuesday,98,5,7,30,140,high
07:45:00 PM,10,Tuesday,91,10,17,28,146,high
08:00:00 PM,10,Tuesday,82,4,9,20,115,high
08:15:00 PM,10,Tuesday,65,10,19,18,112,high
08:30:00 PM,10,Tuesday,54,3,20,15,92,low
08:45:00 PM,10,Tuesday,78,6,16,35,135,high
09:00:00 PM,10,Tuesday,70,20,10,33,133,high
09:15:00 PM,10,Tuesday,90,9,11,11,121,high
09:30:00 PM,10,Tuesday,96,0,19,23,138,high
09:45:00 PM,10,Tuesday,14,1,0,27,42,normal
10:00:00 PM,10,Tuesday,7,1,0,36,44,normal
10:15:00 PM,10,Tuesday,9,0,2,35,46,normal
10:30:00 PM,10,Tuesday,7,0,0,34,41,normal
10:45:00 PM,10,Tuesday,11,0,1,33,45,normal
11:00:00 PM,10,Tuesday,11,2,2,40,55,low
11:15:00 PM,10,Tuesday,11,1,0,31,43,normal
11:30:00 PM,10,Tuesday,9,2,1,20,32,normal
11:45:00 PM,10,Tuesday,8,1,2,31,42,normal
12:00:00 AM,11,Wednesday,9,1,2,29,41,normal
12:15:00 AM,11,Wednesday,12,2,1,32,47,normal
12:30:00 AM,11,Wednesday,11,2,1,33,47,normal
12:45:00 AM,11,Wednesday,7,0,0,29,36,normal
01:00:00 AM,11,Wednesday,5,1,2,21,29,normal
01:15:00 AM,11,Wednesday,13,1,2,20,36,normal
01:30:00 AM,11,Wednesday,7,1,0,40,48,normal
01:45:00 AM,11,Wednesday,13,2,2,30,47,normal
02:00:00 AM,11,Wednesday,10,0,2,35,47,normal
02:15:00 AM,11,Wednesday,15,2,2,32,51,low
02:30:00 AM,11,Wednesday,8,2,2,26,38,normal
02:45:00 AM,11,Wednesday,11,0,0,28,39,normal
03:00:00 AM,11,Wednesday,7,0,1,36,44,normal
03:15:00 AM,11,Wednesday,8,0,1,32,41,normal
03:30:00 AM,11,Wednesday,15,1,0,35,51,low
03:45:00 AM,11,Wednesday,9,1,0,33,43,normal
04:00:00 AM,11,Wednesday,72,7,2,14,95,low
04:15:00 AM,11,Wednesday,64,7,7,20,98,low
04:30:00 AM,11,Wednesday,85,8,5,14,112,low
04:45:00 AM,11,Wednesday,73,6,6,15,100,low
05:00:00 AM,11,Wednesday,57,0,0,15,72,low
05:15:00 AM,11,Wednesday,81,4,4,24,113,high
05:30:00 AM,11,Wednesday,54,6,3,18,81,low
05:45:00 AM,11,Wednesday,97,22,23,12,154,heavy
06:00:00 AM,11,Wednesday,109,10,14,13,146,high
06:15:00 AM,11,Wednesday,102,23,23,11,159,heavy
06:30:00 AM,11,Wednesday,135,13,18,6,172,heavy
06:45:00 AM,11,Wednesday,105,12,13,9,139,high
07:00:00 AM,11,Wednesday,90,17,19,8,134,high
07:15:00 AM,11,Wednesday,104,14,19,7,144,high
07:30:00 AM,11,Wednesday,134,20,24,8,186,heavy
07:45:00 AM,11,Wednesday,120,26,17,8,171,heavy
08:00:00 AM,11,Wednesday,142,19,16,5,182,heavy
08:15:00 AM,11,Wednesday,121,28,20,15,184,heavy
08:30:00 AM,11,Wednesday,85,26,17,9,137,high
08:45:00 AM,11,Wednesday,140,15,14,12,181,heavy
09:00:00 AM,11,Wednesday,68,12,29,12,121,high
09:15:00 AM,11,Wednesday,56,7,14,15,92,low
09:30:00 AM,11,Wednesday,33,14,12,19,78,low
09:45:00 AM,11,Wednesday,61,9,18,6,94,low
10:00:00 AM,11,Wednesday,36,10,24,14,84,low
10:15:00 AM,11,Wednesday,57,13,22,19,111,high
10:30:00 AM,11,Wednesday,64,9,20,19,112,high
10:45:00 AM,11,Wednesday,30,7,1,31,69,low
11:00:00 AM,11,Wednesday,54,10,10,28,102,high
11:15:00 AM,11,Wednesday,28,5,12,29,74,low
11:30:00 AM,11,Wednesday,50,2,4,30,86,low
11:45:00 AM,11,Wednesday,60,4,3,26,93,low
12:00:00 PM,11,Wednesday,39,4,4,30,77,low
12:15:00 PM,11,Wednesday,32,1,12,27,72,low
12:30:00 PM,11,Wednesday,59,3,12,28,102,high
12:45:00 PM,11,Wednesday,64,9,9,25,107,high
01:00:00 PM,11,Wednesday,52,17,17,21,107,high
01:15:00 PM,11,Wednesday,96,14,3,22,135,high
01:30:00 PM,11,Wednesday,61,8,21,24,114,high
01:45:00 PM,11,Wednesday,100,7,11,22,140,high
02:00:00 PM,11,Wednesday,6,8,32,24,70,low
02:15:00 PM,11,Wednesday,88,14,32,26,160,heavy
02:30:00 PM,11,Wednesday,27,14,15,23,79,low
02:45:00 PM,11,Wednesday,22,15,21,10,68,low
03:00:00 PM,11,Wednesday,53,5,17,21,96,low
03:15:00 PM,11,Wednesday,61,11,27,22,121,high
03:30:00 PM,11,Wednesday,74,13,5,26,118,high
03:45:00 PM,11,Wednesday,121,7,16,20,164,high
04:00:00 PM,11,Wednesday,110,9,37,13,169,heavy
04:15:00 PM,11,Wednesday,116,12,39,12,179,heavy
04:30:00 PM,11,Wednesday,100,27,39,13,179,heavy
04:45:00 PM,11,Wednesday,118,11,28,11,168,heavy
05:00:00 PM,11,Wednesday,137,14,13,13,177,heavy
05:15:00 PM,11,Wednesday,130,23,14,18,185,heavy
05:30:00 PM,11,Wednesday,146,13,10,18,187,heavy
05:45:00 PM,11,Wednesday,114,23,19,11,167,heavy
06:00:00 PM,11,Wednesday,104,18,15,15,152,heavy
06:15:00 PM,11,Wednesday,114,24,31,10,179,heavy
06:30:00 PM,11,Wednesday,90,0,18,11,119,high
06:45:00 PM,11,Wednesday,95,2,9,15,121,high
07:00:00 PM,11,Wednesday,60,4,7,28,99,low
07:15:00 PM,11,Wednesday,72,1,9,32,114,high
07:30:00 PM,11,Wednesday,92,20,11,31,154,high
07:45:00 PM,11,Wednesday,70,18,9,23,120,high
08:00:00 PM,11,Wednesday,97,8,17,10,132,high
08:15:00 PM,11,Wednesday,72,11,5,24,112,high
08:30:00 PM,11,Wednesday,60,12,20,28,120,high
08:45:00 PM,11,Wednesday,62,7,7,13,89,low
09:00:00 PM,11,Wednesday,79,19,13,17,128,high
09:15:00 PM,11,Wednesday,92,9,15,19,135,high
09:30:00 PM,11,Wednesday,62,1,5,10,78,low
09:45:00 PM,11,Wednesday,13,0,1,39,53,low
10:00:00 PM,11,Wednesday,15,2,1,24,42,normal
10:15:00 PM,11,Wednesday,12,2,2,22,38,normal
10:30:00 PM,11,Wednesday,5,0,0,36,41,normal
10:45:00 PM,11,Wednesday,11,1,2,26,40,normal
11:00:00 PM,11,Wednesday,6,1,2,28,37,normal
11:15:00 PM,11,Wednesday,6,0,1,27,34,normal
11:30:00 PM,11,Wednesday,10,0,2,33,45,normal
11:45:00 PM,11,Wednesday,5,0,1,27,33,normal
12:00:00 AM,12,Thursday,6,1,2,37,46,normal
12:15:00 AM,12,Thursday,5,2,1,36,44,normal
12:30:00 AM,12,Thursday,6,1,0,26,33,normal
12:45:00 AM,12,Thursday,9,2,0,21,32,normal
01:00:00 AM,12,Thursday,11,2,2,35,50,normal
01:15:00 AM,12,Thursday,8,2,0,34,44,normal
01:30:00 AM,12,Thursday,14,2,0,35,51,normal
01:45:00 AM,12,Thursday,8,0,0,36,44,normal
02:00:00 AM,12,Thursday,10,1,0,21,32,normal
02:15:00 AM,12,Thursday,14,0,1,35,50,normal
02:30:00 AM,12,Thursday,8,1,0,21,30,normal
02:45:00 AM,12,Thursday,12,2,1,37,52,low
03:00:00 AM,12,Thursday,15,2,1,30,48,normal
03:15:00 AM,12,Thursday,12,2,1,33,48,normal
03:30:00 AM,12,Thursday,8,0,2,38,48,normal
03:45:00 AM,12,Thursday,10,1,2,39,52,low
04:00:00 AM,12,Thursday,90,5,0,28,123,high
04:15:00 AM,12,Thursday,57,9,0,15,81,low
04:30:00 AM,12,Thursday,61,5,0,11,77,low
04:45:00 AM,12,Thursday,84,10,6,16,116,high
05:00:00 AM,12,Thursday,59,8,5,18,90,low
05:15:00 AM,12,Thursday,64,5,3,27,99,low
05:30:00 AM,12,Thursday,72,3,5,10,90,low
05:45:00 AM,12,Thursday,102,12,14,7,135,high
06:00:00 AM,12,Thursday,132,16,23,9,180,heavy
06:15:00 AM,12,Thursday,114,11,25,7,157,heavy
06:30:00 AM,12,Thursday,117,18,22,12,169,heavy
06:45:00 AM,12,Thursday,149,15,10,15,189,heavy
07:00:00 AM,12,Thursday,103,29,12,6,150,high
07:15:00 AM,12,Thursday,81,30,16,5,132,high
07:30:00 AM,12,Thursday,140,14,12,12,178,heavy
07:45:00 AM,12,Thursday,88,25,23,5,141,high
08:00:00 AM,12,Thursday,146,17,20,6,189,heavy
08:15:00 AM,12,Thursday,148,16,25,6,195,heavy
08:30:00 AM,12,Thursday,125,21,22,11,179,heavy
08:45:00 AM,12,Thursday,88,30,23,5,146,high
09:00:00 AM,12,Thursday,67,14,24,19,124,high
09:15:00 AM,12,Thursday,56,12,30,16,114,high
09:30:00 AM,12,Thursday,75,9,15,19,118,high
09:45:00 AM,12,Thursday,52,8,5,12,77,low
10:00:00 AM,12,Thursday,40,9,25,12,86,low
10:15:00 AM,12,Thursday,46,7,30,13,96,low
10:30:00 AM,12,Thursday,76,6,8,14,104,high
10:45:00 AM,12,Thursday,62,6,6,25,99,low
11:00:00 AM,12,Thursday,63,8,9,27,107,low
11:15:00 AM,12,Thursday,39,2,12,25,78,low
11:30:00 AM,12,Thursday,55,7,4,35,101,high
11:45:00 AM,12,Thursday,64,9,8,34,115,high
12:00:00 PM,12,Thursday,56,1,5,27,89,low
12:15:00 PM,12,Thursday,43,3,4,35,85,low
12:30:00 PM,12,Thursday,52,0,3,30,85,low
12:45:00 PM,12,Thursday,25,7,4,33,69,low
01:00:00 PM,12,Thursday,47,13,0,18,78,low
01:15:00 PM,12,Thursday,26,16,31,26,99,low
01:30:00 PM,12,Thursday,86,3,9,30,128,high
01:45:00 PM,12,Thursday,46,6,21,11,84,low
02:00:00 PM,12,Thursday,66,13,3,26,108,high
02:15:00 PM,12,Thursday,89,19,21,18,147,high
02:30:00 PM,12,Thursday,88,1,10,21,120,high
02:45:00 PM,12,Thursday,88,8,8,24,128,high
03:00:00 PM,12,Thursday,96,20,28,14,158,heavy
03:15:00 PM,12,Thursday,70,1,20,16,107,high
03:30:00 PM,12,Thursday,79,3,14,22,118,high
03:45:00 PM,12,Thursday,133,6,21,15,175,heavy
04:00:00 PM,12,Thursday,128,11,38,14,191,heavy
04:15:00 PM,12,Thursday,123,27,34,13,197,heavy
04:30:00 PM,12,Thursday,129,23,17,16,185,heavy
04:45:00 PM,12,Thursday,104,22,40,11,177,heavy
05:00:00 PM,12,Thursday,128,9,19,14,170,heavy
05:15:00 PM,12,Thursday,130,10,38,11,189,heavy
05:30:00 PM,12,Thursday,146,14,35,15,210,heavy
05:45:00 PM,12,Thursday,120,22,32,17,191,heavy
06:00:00 PM,12,Thursday,102,25,31,14,172,heavy
06:15:00 PM,12,Thursday,116,11,18,18,163,heavy
06:30:00 PM,12,Thursday,83,19,15,22,139,high
06:45:00 PM,12,Thursday,67,10,11,24,112,high
07:00:00 PM,12,Thursday,98,5,9,25,137,high
07:15:00 PM,12,Thursday,61,2,11,31,105,high
07:30:00 PM,12,Thursday,80,14,5,15,114,high
07:45:00 PM,12,Thursday,59,5,6,11,81,low
08:00:00 PM,12,Thursday,68,14,20,10,112,high
08:15:00 PM,12,Thursday,84,15,12,16,127,high
08:30:00 PM,12,Thursday,67,19,16,17,119,high
08:45:00 PM,12,Thursday,53,14,19,33,119,high
09:00:00 PM,12,Thursday,50,1,6,20,77,low
09:15:00 PM,12,Thursday,64,0,9,32,105,high
09:30:00 PM,12,Thursday,70,4,5,24,103,high
09:45:00 PM,12,Thursday,5,0,0,38,43,normal
10:00:00 PM,12,Thursday,11,2,0,38,51,low
10:15:00 PM,12,Thursday,11,1,1,40,53,low
10:30:00 PM,12,Thursday,12,1,2,31,46,normal
10:45:00 PM,12,Thursday,5,1,0,36,42,normal
11:00:00 PM,12,Thursday,5,0,0,23,28,normal
11:15:00 PM,12,Thursday,6,0,2,26,34,normal
11:30:00 PM,12,Thursday,15,1,2,20,38,normal
11:45:00 PM,12,Thursday,6,2,0,24,32,normal
12:00:00 AM,13,Friday,6,1,2,40,49,normal
12:15:00 AM,13,Friday,6,1,0,39,46,normal
12:30:00 AM,13,Friday,15,1,2,23,41,normal
12:45:00 AM,13,Friday,7,1,2,35,45,normal
01:00:00 AM,13,Friday,15,0,0,22,37,normal
01:15:00 AM,13,Friday,11,2,2,33,48,normal
01:30:00 AM,13,Friday,14,2,1,24,41,normal
01:45:00 AM,13,Friday,5,2,2,36,45,normal
02:00:00 AM,13,Friday,9,0,2,35,46,normal
02:15:00 AM,13,Friday,14,0,0,30,44,normal
02:30:00 AM,13,Friday,5,0,0,29,34,normal
02:45:00 AM,13,Friday,9,0,1,36,46,normal
03:00:00 AM,13,Friday,15,1,2,36,54,low
03:15:00 AM,13,Friday,11,1,0,20,32,normal
03:30:00 AM,13,Friday,14,1,2,29,46,normal
03:45:00 AM,13,Friday,5,0,1,38,44,normal
04:00:00 AM,13,Friday,54,7,2,27,90,low
04:15:00 AM,13,Friday,52,5,2,54,113,high
04:30:00 AM,13,Friday,64,7,3,59,133,high
04:45:00 AM,13,Friday,28,7,4,35,74,low
05:00:00 AM,13,Friday,79,2,2,48,131,high
05:15:00 AM,13,Friday,58,0,3,35,96,low
05:30:00 AM,13,Friday,43,4,0,48,95,low
05:45:00 AM,13,Friday,72,5,3,57,137,high
06:00:00 AM,13,Friday,63,0,0,43,106,high
06:15:00 AM,13,Friday,58,10,1,58,127,high
06:30:00 AM,13,Friday,25,2,3,26,56,low
06:45:00 AM,13,Friday,26,6,2,56,90,low
07:00:00 AM,13,Friday,53,5,5,25,88,low
07:15:00 AM,13,Friday,34,6,1,34,75,low
07:30:00 AM,13,Friday,27,3,5,53,88,low
07:45:00 AM,13,Friday,77,0,3,44,124,high
08:00:00 AM,13,Friday,65,10,1,52,128,high
08:15:00 AM,13,Friday,65,6,3,55,129,high
08:30:00 AM,13,Friday,78,6,2,35,121,high
08:45:00 AM,13,Friday,36,6,5,57,104,high
09:00:00 AM,13,Friday,144,42,11,7,204,heavy
09:15:00 AM,13,Friday,125,29,19,6,179,heavy
09:30:00 AM,13,Friday,114,50,6,8,178,heavy
09:45:00 AM,13,Friday,136,24,20,6,186,heavy
10:00:00 AM,13,Friday,114,37,19,7,177,heavy
10:15:00 AM,13,Friday,141,50,16,5,212,heavy
10:30:00 AM,13,Friday,117,50,20,10,197,heavy
10:45:00 AM,13,Friday,103,40,11,9,163,heavy
11:00:00 AM,13,Friday,131,39,5,5,180,heavy
11:15:00 AM,13,Friday,119,22,6,8,155,heavy
11:30:00 AM,13,Friday,104,35,19,9,167,heavy
11:45:00 AM,13,Friday,146,24,13,6,189,heavy
12:00:00 PM,13,Friday,134,26,14,6,180,heavy
12:15:00 PM,13,Friday,111,46,19,8,184,heavy
12:30:00 PM,13,Friday,106,37,19,8,170,heavy
12:45:00 PM,13,Friday,128,36,12,9,185,heavy
01:00:00 PM,13,Friday,101,36,11,9,157,heavy
01:15:00 PM,13,Friday,142,21,7,9,179,heavy
01:30:00 PM,13,Friday,124,21,10,5,160,heavy
01:45:00 PM,13,Friday,103,22,20,7,152,heavy
02:00:00 PM,13,Friday,139,47,7,8,201,heavy
02:15:00 PM,13,Friday,127,28,20,10,185,heavy
02:30:00 PM,13,Friday,126,39,13,7,185,heavy
02:45:00 PM,13,Friday,100,41,15,8,164,heavy
03:00:00 PM,13,Friday,66,5,5,17,93,low
03:15:00 PM,13,Friday,83,13,9,10,115,heavy
03:30:00 PM,13,Friday,50,6,15,9,80,low
03:45:00 PM,13,Friday,50,13,1,11,75,low
04:00:00 PM,13,Friday,65,5,1,20,91,low
04:15:00 PM,13,Friday,72,8,12,19,111,low
04:30:00 PM,13,Friday,80,7,0,9,96,low
04:45:00 PM,13,Friday,71,5,10,5,91,low
05:00:00 PM,13,Friday,83,11,2,12,108,high
05:15:00 PM,13,Friday,54,5,6,10,75,low
05:30:00 PM,13,Friday,55,6,4,10,75,low
05:45:00 PM,13,Friday,56,15,14,5,90,low
06:00:00 PM,13,Friday,71,8,13,12,104,high
06:15:00 PM,13,Friday,59,5,13,18,95,low
06:30:00 PM,13,Friday,62,14,4,10,90,low
06:45:00 PM,13,Friday,68,10,9,20,107,high
07:00:00 PM,13,Friday,27,0,3,40,70,low
07:15:00 PM,13,Friday,45,3,1,44,93,low
07:30:00 PM,13,Friday,23,3,1,39,66,low
07:45:00 PM,13,Friday,50,4,4,40,98,low
08:00:00 PM,13,Friday,29,2,4,39,74,low
08:15:00 PM,13,Friday,26,1,5,30,62,low
08:30:00 PM,13,Friday,43,4,5,39,91,low
08:45:00 PM,13,Friday,33,5,0,25,63,low
09:00:00 PM,13,Friday,21,2,4,30,57,low
09:15:00 PM,13,Friday,47,2,4,40,93,low
09:30:00 PM,13,Friday,24,4,4,41,73,low
09:45:00 PM,13,Friday,11,0,2,27,40,normal
10:00:00 PM,13,Friday,5,1,1,37,44,normal
10:15:00 PM,13,Friday,14,2,1,22,39,normal
10:30:00 PM,13,Friday,6,2,0,39,47,normal
10:45:00 PM,13,Friday,15,2,2,37,56,low
11:00:00 PM,13,Friday,9,2,2,36,49,normal
11:15:00 PM,13,Friday,11,0,0,34,45,normal
11:30:00 PM,13,Friday,13,1,2,25,41,normal
11:45:00 PM,13,Friday,13,1,2,31,47,normal
12:00:00 AM,14,Saturday,10,0,0,37,47,normal
12:15:00 AM,14,Saturday,6,2,0,20,28,normal
12:30:00 AM,14,Saturday,12,1,1,36,50,normal
12:45:00 AM,14,Saturday,9,2,0,27,38,normal
01:00:00 AM,14,Saturday,13,1,0,35,49,normal
01:15:00 AM,14,Saturday,7,0,1,40,48,normal
01:30:00 AM,14,Saturday,6,1,1,37,45,normal
01:45:00 AM,14,Saturday,8,1,1,27,37,normal
02:00:00 AM,14,Saturday,9,2,2,30,43,normal
02:15:00 AM,14,Saturday,7,1,0,38,46,normal
02:30:00 AM,14,Saturday,6,0,1,35,42,normal
02:45:00 AM,14,Saturday,7,0,2,27,36,normal
03:00:00 AM,14,Saturday,5,0,0,36,41,normal
03:15:00 AM,14,Saturday,11,2,2,25,40,normal
03:30:00 AM,14,Saturday,5,1,2,22,30,normal
03:45:00 AM,14,Saturday,14,0,1,30,45,normal
04:00:00 AM,14,Saturday,55,1,1,30,87,low
04:15:00 AM,14,Saturday,74,10,1,10,95,low
04:30:00 AM,14,Saturday,89,7,1,21,118,high
04:45:00 AM,14,Saturday,87,9,6,17,119,high
05:00:00 AM,14,Saturday,80,10,3,19,112,high
05:15:00 AM,14,Saturday,89,7,0,25,121,high
05:30:00 AM,14,Saturday,89,6,6,17,118,high
05:45:00 AM,14,Saturday,134,12,20,5,171,heavy
06:00:00 AM,14,Saturday,104,16,11,15,146,high
06:15:00 AM,14,Saturday,132,10,20,13,175,heavy
06:30:00 AM,14,Saturday,112,16,18,12,158,heavy
06:45:00 AM,14,Saturday,84,25,11,15,135,high
07:00:00 AM,14,Saturday,101,25,21,15,162,heavy
07:15:00 AM,14,Saturday,141,16,25,10,192,heavy
07:30:00 AM,14,Saturday,108,29,23,11,171,heavy
07:45:00 AM,14,Saturday,147,27,25,7,206,heavy
08:00:00 AM,14,Saturday,102,10,18,12,142,high
08:15:00 AM,14,Saturday,141,30,19,7,197,heavy
08:30:00 AM,14,Saturday,118,23,19,15,175,heavy
08:45:00 AM,14,Saturday,90,27,12,10,139,high
09:00:00 AM,14,Saturday,35,5,25,11,76,low
09:15:00 AM,14,Saturday,80,11,8,19,118,high
09:30:00 AM,14,Saturday,71,15,7,10,103,high
09:45:00 AM,14,Saturday,58,5,5,7,75,low
10:00:00 AM,14,Saturday,36,5,15,19,75,low
10:15:00 AM,14,Saturday,36,15,22,11,84,low
10:30:00 AM,14,Saturday,30,12,20,17,79,low
10:45:00 AM,14,Saturday,29,5,11,29,74,low
11:00:00 AM,14,Saturday,34,8,10,25,77,low
11:15:00 AM,14,Saturday,61,3,6,31,101,high
11:30:00 AM,14,Saturday,52,7,5,27,91,low
11:45:00 AM,14,Saturday,24,0,12,34,70,low
12:00:00 PM,14,Saturday,28,9,5,25,67,low
12:15:00 PM,14,Saturday,42,0,4,33,79,low
12:30:00 PM,14,Saturday,31,4,9,26,70,low
12:45:00 PM,14,Saturday,29,2,4,34,69,low
01:00:00 PM,14,Saturday,64,19,22,13,118,high
01:15:00 PM,14,Saturday,84,1,11,16,112,high
01:30:00 PM,14,Saturday,20,0,17,24,61,low
01:45:00 PM,14,Saturday,82,16,32,22,152,heavy
02:00:00 PM,14,Saturday,80,14,22,25,141,high
02:15:00 PM,14,Saturday,18,16,10,14,58,low
02:30:00 PM,14,Saturday,57,12,30,15,114,high
02:45:00 PM,14,Saturday,50,1,21,25,97,low
03:00:00 PM,14,Saturday,6,4,5,10,25,normal
03:15:00 PM,14,Saturday,78,19,30,23,150,high
03:30:00 PM,14,Saturday,38,8,18,30,94,low
03:45:00 PM,14,Saturday,129,18,12,17,176,heavy
04:00:00 PM,14,Saturday,114,9,39,11,173,heavy
04:15:00 PM,14,Saturday,139,8,40,17,204,heavy
04:30:00 PM,14,Saturday,108,20,10,15,153,heavy
04:45:00 PM,14,Saturday,129,11,12,20,172,heavy
05:00:00 PM,14,Saturday,149,22,31,13,215,heavy
05:15:00 PM,14,Saturday,120,27,37,12,196,heavy
05:30:00 PM,14,Saturday,120,6,37,18,181,heavy
05:45:00 PM,14,Saturday,124,28,32,18,202,heavy
06:00:00 PM,14,Saturday,116,10,28,19,173,heavy
06:15:00 PM,14,Saturday,100,9,10,11,130,high
06:30:00 PM,14,Saturday,88,8,20,33,149,high
06:45:00 PM,14,Saturday,94,16,15,20,145,high
07:00:00 PM,14,Saturday,94,17,19,35,165,heavy
07:15:00 PM,14,Saturday,51,20,7,25,103,high
07:30:00 PM,14,Saturday,58,12,20,19,109,high
07:45:00 PM,14,Saturday,74,8,10,13,105,high
08:00:00 PM,14,Saturday,92,9,11,32,144,high
08:15:00 PM,14,Saturday,92,5,17,12,126,high
08:30:00 PM,14,Saturday,50,9,18,18,95,low
08:45:00 PM,14,Saturday,80,11,14,14,119,high
09:00:00 PM,14,Saturday,102,10,13,13,138,high
09:15:00 PM,14,Saturday,68,13,18,13,112,high
09:30:00 PM,14,Saturday,108,4,17,13,142,high
09:45:00 PM,14,Saturday,13,1,2,20,36,normal
10:00:00 PM,14,Saturday,8,0,2,34,44,normal
10:15:00 PM,14,Saturday,11,2,2,40,55,low
10:30:00 PM,14,Saturday,13,1,1,28,43,normal
10:45:00 PM,14,Saturday,12,0,2,23,37,normal
11:00:00 PM,14,Saturday,9,0,1,20,30,normal
11:15:00 PM,14,Saturday,8,1,2,21,32,normal
11:30:00 PM,14,Saturday,7,1,1,26,35,normal
11:45:00 PM,14,Saturday,6,0,1,22,29,normal
12:00:00 AM,15,Sunday,11,2,0,35,48,normal
12:15:00 AM,15,Sunday,7,2,0,24,33,normal
12:30:00 AM,15,Sunday,7,2,2,28,39,normal
12:45:00 AM,15,Sunday,13,0,2,24,39,normal
01:00:00 AM,15,Sunday,13,1,2,27,43,normal
01:15:00 AM,15,Sunday,7,1,1,32,41,normal
01:30:00 AM,15,Sunday,7,0,2,24,33,normal
01:45:00 AM,15,Sunday,6,2,0,25,33,normal
02:00:00 AM,15,Sunday,5,0,0,26,31,normal
02:15:00 AM,15,Sunday,6,0,2,20,28,normal
02:30:00 AM,15,Sunday,10,2,1,35,48,normal
02:45:00 AM,15,Sunday,14,1,0,22,37,normal
03:00:00 AM,15,Sunday,13,1,1,24,39,normal
03:15:00 AM,15,Sunday,13,1,1,23,38,normal
03:30:00 AM,15,Sunday,15,0,0,39,54,low
03:45:00 AM,15,Sunday,9,2,2,25,38,normal
04:00:00 AM,15,Sunday,76,7,2,14,99,low
04:15:00 AM,15,Sunday,75,4,4,23,106,high
04:30:00 AM,15,Sunday,54,8,0,16,78,low
04:45:00 AM,15,Sunday,60,5,6,25,96,low
05:00:00 AM,15,Sunday,70,4,6,21,101,high
05:15:00 AM,15,Sunday,70,10,7,24,111,high
05:30:00 AM,15,Sunday,50,2,3,26,81,low
05:45:00 AM,15,Sunday,128,11,25,13,177,heavy
06:00:00 AM,15,Sunday,131,23,15,11,180,heavy
06:15:00 AM,15,Sunday,140,24,17,8,189,heavy
06:30:00 AM,15,Sunday,113,23,23,10,169,heavy
06:45:00 AM,15,Sunday,109,22,13,8,152,heavy
07:00:00 AM,15,Sunday,143,11,11,12,177,heavy
07:15:00 AM,15,Sunday,137,24,25,8,194,heavy
07:30:00 AM,15,Sunday,109,27,14,8,158,heavy
07:45:00 AM,15,Sunday,87,30,17,8,142,high
08:00:00 AM,15,Sunday,91,14,13,5,123,high
08:15:00 AM,15,Sunday,86,15,16,14,131,high
08:30:00 AM,15,Sunday,134,13,24,11,182,heavy
08:45:00 AM,15,Sunday,137,13,20,9,179,heavy
09:00:00 AM,15,Sunday,47,15,26,15,103,high
09:15:00 AM,15,Sunday,52,8,23,17,100,high
09:30:00 AM,15,Sunday,77,5,5,14,101,high
09:45:00 AM,15,Sunday,43,13,24,14,94,low
10:00:00 AM,15,Sunday,68,14,30,19,131,high
10:15:00 AM,15,Sunday,46,5,11,13,75,low
10:30:00 AM,15,Sunday,80,11,5,16,112,high
10:45:00 AM,15,Sunday,43,8,1,27,79,low
11:00:00 AM,15,Sunday,66,7,12,27,112,high
11:15:00 AM,15,Sunday,34,0,2,33,69,low
11:30:00 AM,15,Sunday,65,2,8,30,105,high
11:45:00 AM,15,Sunday,59,7,9,29,104,high
12:00:00 PM,15,Sunday,55,7,4,28,94,low
12:15:00 PM,15,Sunday,41,4,9,35,89,low
12:30:00 PM,15,Sunday,32,0,8,25,65,low
12:45:00 PM,15,Sunday,48,2,12,30,92,low
01:00:00 PM,15,Sunday,36,16,12,13,77,low
01:15:00 PM,15,Sunday,43,2,23,22,90,low
01:30:00 PM,15,Sunday,13,3,24,30,70,low
01:45:00 PM,15,Sunday,90,20,22,18,150,high
02:00:00 PM,15,Sunday,98,4,20,28,150,high
02:15:00 PM,15,Sunday,95,6,27,14,142,high
02:30:00 PM,15,Sunday,39,13,8,11,71,low
02:45:00 PM,15,Sunday,54,15,8,11,88,low
03:00:00 PM,15,Sunday,28,19,13,11,71,low
03:15:00 PM,15,Sunday,7,4,5,23,39,normal
03:30:00 PM,15,Sunday,29,18,9,15,71,low
03:45:00 PM,15,Sunday,122,18,18,19,177,heavy
04:00:00 PM,15,Sunday,150,30,14,17,211,heavy
04:15:00 PM,15,Sunday,113,25,28,12,178,heavy
04:30:00 PM,15,Sunday,116,23,39,17,195,heavy
04:45:00 PM,15,Sunday,127,14,40,11,192,heavy
05:00:00 PM,15,Sunday,116,15,33,20,184,heavy
05:15:00 PM,15,Sunday,136,15,15,18,184,heavy
05:30:00 PM,15,Sunday,120,17,14,11,162,heavy
05:45:00 PM,15,Sunday,109,25,35,12,181,heavy
06:00:00 PM,15,Sunday,134,21,26,15,196,heavy
06:15:00 PM,15,Sunday,135,10,36,15,196,heavy
06:30:00 PM,15,Sunday,77,1,10,25,113,high
06:45:00 PM,15,Sunday,107,15,13,11,146,high
07:00:00 PM,15,Sunday,106,16,5,19,146,high
07:15:00 PM,15,Sunday,52,17,5,16,90,low
07:30:00 PM,15,Sunday,100,19,5,22,146,high
07:45:00 PM,15,Sunday,107,13,13,22,155,heavy
08:00:00 PM,15,Sunday,67,7,20,33,127,high
08:15:00 PM,15,Sunday,100,15,10,11,136,high
08:30:00 PM,15,Sunday,110,1,18,20,149,high
08:45:00 PM,15,Sunday,92,14,10,11,127,high
09:00:00 PM,15,Sunday,109,14,16,14,153,heavy
09:15:00 PM,15,Sunday,85,17,11,28,141,high
09:30:00 PM,15,Sunday,101,12,16,12,141,high
09:45:00 PM,15,Sunday,10,0,0,25,35,normal
10:00:00 PM,15,Sunday,12,2,1,32,47,normal
10:15:00 PM,15,Sunday,13,2,0,40,55,low
10:30:00 PM,15,Sunday,15,1,0,30,46,normal
10:45:00 PM,15,Sunday,6,1,0,34,41,normal
11:00:00 PM,15,Sunday,11,1,1,39,52,low
11:15:00 PM,15,Sunday,9,2,1,23,35,normal
11:30:00 PM,15,Sunday,10,2,2,28,42,normal
11:45:00 PM,15,Sunday,12,0,1,38,51,low
12:00:00 AM,16,Monday,11,2,2,39,54,low
12:15:00 AM,16,Monday,7,1,0,29,37,normal
12:30:00 AM,16,Monday,15,0,2,33,50,normal
12:45:00 AM,16,Monday,10,0,0,20,30,normal
01:00:00 AM,16,Monday,6,0,1,40,47,normal
01:15:00 AM,16,Monday,12,1,2,31,46,normal
01:30:00 AM,16,Monday,15,0,0,26,41,normal
01:45:00 AM,16,Monday,10,0,1,31,42,normal
02:00:00 AM,16,Monday,9,0,2,38,49,normal
02:15:00 AM,16,Monday,9,2,2,37,50,normal
02:30:00 AM,16,Monday,7,0,0,34,41,normal
02:45:00 AM,16,Monday,12,2,1,26,41,normal
03:00:00 AM,16,Monday,15,0,0,34,49,normal
03:15:00 AM,16,Monday,11,0,1,29,41,normal
03:30:00 AM,16,Monday,9,1,1,30,41,normal
03:45:00 AM,16,Monday,5,2,0,28,35,normal
04:00:00 AM,16,Monday,70,1,0,25,96,normal
04:15:00 AM,16,Monday,74,0,6,25,105,high
04:30:00 AM,16,Monday,81,3,1,20,105,high
04:45:00 AM,16,Monday,71,2,4,21,98,low
05:00:00 AM,16,Monday,75,7,1,28,111,high
05:15:00 AM,16,Monday,88,5,5,25,123,high
05:30:00 AM,16,Monday,71,2,4,19,96,low
05:45:00 AM,16,Monday,115,10,11,15,151,heavy
06:00:00 AM,16,Monday,147,26,11,5,189,heavy
06:15:00 AM,16,Monday,102,15,20,10,147,high
06:30:00 AM,16,Monday,80,12,25,9,126,high
06:45:00 AM,16,Monday,97,23,25,7,152,heavy
07:00:00 AM,16,Monday,81,23,24,8,136,high
07:15:00 AM,16,Monday,130,16,10,15,171,heavy
07:30:00 AM,16,Monday,103,13,24,13,153,heavy
07:45:00 AM,16,Monday,138,22,20,8,188,heavy
08:00:00 AM,16,Monday,128,16,22,12,178,heavy
08:15:00 AM,16,Monday,91,14,11,8,124,high
08:30:00 AM,16,Monday,141,27,12,9,189,heavy
08:45:00 AM,16,Monday,114,19,25,5,163,heavy
09:00:00 AM,16,Monday,53,14,30,10,107,high
09:15:00 AM,16,Monday,69,9,17,5,100,low
09:30:00 AM,16,Monday,39,8,16,10,73,low
09:45:00 AM,16,Monday,71,13,25,8,117,high
10:00:00 AM,16,Monday,48,8,29,12,97,low
10:15:00 AM,16,Monday,73,14,18,17,122,high
10:30:00 AM,16,Monday,61,8,7,18,94,low
10:45:00 AM,16,Monday,44,7,11,30,92,low
11:00:00 AM,16,Monday,59,0,7,35,101,high
11:15:00 AM,16,Monday,50,3,5,29,87,low
11:30:00 AM,16,Monday,26,3,5,28,62,low
11:45:00 AM,16,Monday,24,7,13,34,78,low
12:00:00 PM,16,Monday,35,3,3,33,74,low
12:15:00 PM,16,Monday,59,10,9,25,103,high
12:30:00 PM,16,Monday,31,2,5,33,71,low
12:45:00 PM,16,Monday,21,10,7,31,69,low
01:00:00 PM,16,Monday,68,20,24,14,126,high
01:15:00 PM,16,Monday,31,4,21,22,78,low
01:30:00 PM,16,Monday,44,6,18,17,85,low
01:45:00 PM,16,Monday,39,16,27,26,108,high
02:00:00 PM,16,Monday,25,19,35,18,97,low
02:15:00 PM,16,Monday,16,4,29,14,63,low
02:30:00 PM,16,Monday,8,11,24,12,55,low
02:45:00 PM,16,Monday,35,18,3,16,72,low
03:00:00 PM,16,Monday,95,16,16,21,148,high
03:15:00 PM,16,Monday,8,3,32,22,65,low
03:30:00 PM,16,Monday,30,19,14,18,81,low
03:45:00 PM,16,Monday,125,11,26,11,173,heavy
04:00:00 PM,16,Monday,130,10,30,20,190,heavy
04:15:00 PM,16,Monday,149,27,24,19,219,heavy
04:30:00 PM,16,Monday,107,25,38,14,184,heavy
04:45:00 PM,16,Monday,129,16,23,10,178,heavy
05:00:00 PM,16,Monday,131,7,33,13,184,heavy
05:15:00 PM,16,Monday,124,20,13,14,171,heavy
05:30:00 PM,16,Monday,102,20,17,16,155,heavy
05:45:00 PM,16,Monday,144,13,12,20,189,heavy
06:00:00 PM,16,Monday,148,9,37,18,212,heavy
06:15:00 PM,16,Monday,141,11,33,16,201,heavy
06:30:00 PM,16,Monday,96,18,5,30,149,high
06:45:00 PM,16,Monday,85,7,13,31,136,high
07:00:00 PM,16,Monday,101,0,19,33,153,heavy
07:15:00 PM,16,Monday,83,1,6,24,114,high
07:30:00 PM,16,Monday,61,10,13,30,114,high
07:45:00 PM,16,Monday,101,6,20,27,154,heavy
08:00:00 PM,16,Monday,107,0,15,27,149,high
08:15:00 PM,16,Monday,78,3,12,33,126,high
08:30:00 PM,16,Monday,77,20,7,22,126,high
08:45:00 PM,16,Monday,108,10,5,21,144,high
09:00:00 PM,16,Monday,55,0,19,25,99,low
09:15:00 PM,16,Monday,61,10,14,35,120,high
09:30:00 PM,16,Monday,88,18,7,23,136,high
09:45:00 PM,16,Monday,7,0,1,38,46,normal
10:00:00 PM,16,Monday,12,0,0,35,47,normal
10:15:00 PM,16,Monday,7,2,1,35,45,normal
10:30:00 PM,16,Monday,14,2,1,21,38,normal
10:45:00 PM,16,Monday,10,1,1,20,32,normal
11:00:00 PM,16,Monday,6,2,0,31,39,normal
11:15:00 PM,16,Monday,5,2,1,40,48,normal
11:30:00 PM,16,Monday,14,0,2,40,56,low
11:45:00 PM,16,Monday,6,0,2,32,40,normal
12:00:00 AM,17,Tuesday,14,0,2,27,43,normal
12:15:00 AM,17,Tuesday,8,1,1,21,31,normal
12:30:00 AM,17,Tuesday,11,2,2,21,36,normal
12:45:00 AM,17,Tuesday,10,2,0,33,45,normal
01:00:00 AM,17,Tuesday,13,1,2,29,45,normal
01:15:00 AM,17,Tuesday,6,2,0,27,35,normal
01:30:00 AM,17,Tuesday,7,2,0,22,31,normal
01:45:00 AM,17,Tuesday,5,2,2,37,46,normal
02:00:00 AM,17,Tuesday,14,2,1,40,57,low
02:15:00 AM,17,Tuesday,14,0,0,31,45,normal
02:30:00 AM,17,Tuesday,10,0,2,39,51,low
02:45:00 AM,17,Tuesday,8,2,0,40,50,normal
03:00:00 AM,17,Tuesday,15,0,1,35,51,low
03:15:00 AM,17,Tuesday,11,1,1,37,50,normal
03:30:00 AM,17,Tuesday,15,1,2,27,45,normal
03:45:00 AM,17,Tuesday,15,2,1,40,58,low
04:00:00 AM,17,Tuesday,83,9,0,14,106,high
04:15:00 AM,17,Tuesday,82,3,0,30,115,high
04:30:00 AM,17,Tuesday,76,4,6,15,101,high
04:45:00 AM,17,Tuesday,59,5,2,11,77,low
05:00:00 AM,17,Tuesday,59,5,3,27,94,low
05:15:00 AM,17,Tuesday,71,4,6,17,98,low
05:30:00 AM,17,Tuesday,70,4,4,23,101,high
05:45:00 AM,17,Tuesday,104,11,19,9,143,high
06:00:00 AM,17,Tuesday,136,30,11,5,182,heavy
06:15:00 AM,17,Tuesday,86,13,21,9,129,high
06:30:00 AM,17,Tuesday,131,19,18,11,179,heavy
06:45:00 AM,17,Tuesday,90,16,14,13,133,high
07:00:00 AM,17,Tuesday,129,13,17,5,164,heavy
07:15:00 AM,17,Tuesday,91,10,25,14,140,high
07:30:00 AM,17,Tuesday,86,10,20,14,130,high
07:45:00 AM,17,Tuesday,100,19,17,8,144,high
08:00:00 AM,17,Tuesday,84,11,10,11,116,high
08:15:00 AM,17,Tuesday,109,29,25,11,174,heavy
08:30:00 AM,17,Tuesday,93,22,15,8,138,high
08:45:00 AM,17,Tuesday,92,17,16,5,130,high
09:00:00 AM,17,Tuesday,80,7,11,17,115,high
09:15:00 AM,17,Tuesday,30,11,24,7,72,low
09:30:00 AM,17,Tuesday,35,14,14,12,75,low
09:45:00 AM,17,Tuesday,70,5,25,7,107,high
10:00:00 AM,17,Tuesday,59,10,7,16,92,low
10:15:00 AM,17,Tuesday,56,12,7,6,81,low
10:30:00 AM,17,Tuesday,77,10,5,18,110,high
10:45:00 AM,17,Tuesday,64,2,10,34,110,high
11:00:00 AM,17,Tuesday,37,3,13,28,81,low
11:15:00 AM,17,Tuesday,51,6,8,33,98,low
11:30:00 AM,17,Tuesday,33,1,9,30,73,low
11:45:00 AM,17,Tuesday,70,1,11,31,113,high
12:00:00 PM,17,Tuesday,39,0,1,26,66,low
12:15:00 PM,17,Tuesday,49,4,11,35,99,low
12:30:00 PM,17,Tuesday,33,2,0,25,60,low
12:45:00 PM,17,Tuesday,49,8,1,32,90,low
01:00:00 PM,17,Tuesday,70,2,16,14,102,low
01:15:00 PM,17,Tuesday,23,16,20,26,85,low
01:30:00 PM,17,Tuesday,17,8,12,10,47,normal
01:45:00 PM,17,Tuesday,37,2,7,29,75,low
02:00:00 PM,17,Tuesday,38,1,0,10,49,normal
02:15:00 PM,17,Tuesday,8,17,20,18,63,low
02:30:00 PM,17,Tuesday,24,16,29,23,92,low
02:45:00 PM,17,Tuesday,11,0,17,26,54,low
03:00:00 PM,17,Tuesday,15,3,20,28,66,low
03:15:00 PM,17,Tuesday,59,15,31,29,134,high
03:30:00 PM,17,Tuesday,7,11,17,25,60,low
03:45:00 PM,17,Tuesday,116,19,35,11,181,heavy
04:00:00 PM,17,Tuesday,123,5,31,13,172,heavy
04:15:00 PM,17,Tuesday,107,16,17,11,151,high
04:30:00 PM,17,Tuesday,117,6,17,16,156,heavy
04:45:00 PM,17,Tuesday,102,10,15,11,138,high
05:00:00 PM,17,Tuesday,100,12,14,15,141,high
05:15:00 PM,17,Tuesday,142,22,25,18,207,heavy
05:30:00 PM,17,Tuesday,104,19,12,16,151,heavy
05:45:00 PM,17,Tuesday,105,23,17,13,158,heavy
06:00:00 PM,17,Tuesday,101,30,23,18,172,heavy
06:15:00 PM,17,Tuesday,138,16,14,19,187,heavy
06:30:00 PM,17,Tuesday,96,5,18,26,145,high
06:45:00 PM,17,Tuesday,70,17,20,34,141,high
07:00:00 PM,17,Tuesday,62,10,15,26,113,high
07:15:00 PM,17,Tuesday,101,18,15,15,149,high
07:30:00 PM,17,Tuesday,83,1,5,31,120,high
07:45:00 PM,17,Tuesday,104,20,20,20,164,heavy
08:00:00 PM,17,Tuesday,107,9,6,20,142,high
08:15:00 PM,17,Tuesday,100,2,11,23,136,high
08:30:00 PM,17,Tuesday,110,2,18,21,151,heavy
08:45:00 PM,17,Tuesday,110,2,14,31,157,heavy
09:00:00 PM,17,Tuesday,65,20,14,17,116,high
09:15:00 PM,17,Tuesday,53,18,10,35,116,high
09:30:00 PM,17,Tuesday,65,2,13,33,113,high
09:45:00 PM,17,Tuesday,14,0,0,26,40,normal
10:00:00 PM,17,Tuesday,7,1,0,24,32,normal
10:15:00 PM,17,Tuesday,8,0,0,21,29,normal
10:30:00 PM,17,Tuesday,15,0,0,32,47,normal
10:45:00 PM,17,Tuesday,15,2,2,20,39,normal
11:00:00 PM,17,Tuesday,11,1,0,37,49,normal
11:15:00 PM,17,Tuesday,5,0,0,37,42,normal
11:30:00 PM,17,Tuesday,10,2,2,28,42,normal
11:45:00 PM,17,Tuesday,15,0,2,40,57,low
12:00:00 AM,18,Wednesday,11,2,0,39,52,low
12:15:00 AM,18,Wednesday,11,2,1,28,42,normal
12:30:00 AM,18,Wednesday,5,1,1,29,36,normal
12:45:00 AM,18,Wednesday,7,2,0,27,36,normal
01:00:00 AM,18,Wednesday,7,2,1,22,32,normal
01:15:00 AM,18,Wednesday,10,2,1,38,51,low
01:30:00 AM,18,Wednesday,6,1,2,25,34,normal
01:45:00 AM,18,Wednesday,15,2,1,27,45,normal
02:00:00 AM,18,Wednesday,7,1,0,36,44,normal
02:15:00 AM,18,Wednesday,14,2,0,38,54,low
02:30:00 AM,18,Wednesday,15,2,0,27,44,normal
02:45:00 AM,18,Wednesday,6,1,1,30,38,normal
03:00:00 AM,18,Wednesday,7,0,1,24,32,normal
03:15:00 AM,18,Wednesday,13,0,1,24,38,normal
03:30:00 AM,18,Wednesday,11,2,2,22,37,normal
03:45:00 AM,18,Wednesday,13,2,1,36,52,low
04:00:00 AM,18,Wednesday,88,6,5,19,118,high
04:15:00 AM,18,Wednesday,60,0,6,18,84,low
04:30:00 AM,18,Wednesday,54,6,6,14,80,low
04:45:00 AM,18,Wednesday,66,0,2,20,88,low
05:00:00 AM,18,Wednesday,68,6,6,11,91,low
05:15:00 AM,18,Wednesday,89,9,1,14,113,high
05:30:00 AM,18,Wednesday,56,1,0,24,81,low
05:45:00 AM,18,Wednesday,101,24,15,9,149,high
06:00:00 AM,18,Wednesday,120,28,20,10,178,heavy
06:15:00 AM,18,Wednesday,95,29,18,12,154,heavy
06:30:00 AM,18,Wednesday,94,13,21,11,139,high
06:45:00 AM,18,Wednesday,141,30,24,12,207,heavy
07:00:00 AM,18,Wednesday,144,26,18,13,201,heavy
07:15:00 AM,18,Wednesday,107,26,22,11,166,heavy
07:30:00 AM,18,Wednesday,118,27,10,12,167,heavy
07:45:00 AM,18,Wednesday,136,16,24,10,186,heavy
08:00:00 AM,18,Wednesday,139,30,21,15,205,heavy
08:15:00 AM,18,Wednesday,103,19,15,14,151,heavy
08:30:00 AM,18,Wednesday,127,18,11,15,171,heavy
08:45:00 AM,18,Wednesday,101,29,16,8,154,heavy
09:00:00 AM,18,Wednesday,55,8,20,19,102,high
09:15:00 AM,18,Wednesday,56,7,8,14,85,low
09:30:00 AM,18,Wednesday,34,7,8,9,58,low
09:45:00 AM,18,Wednesday,57,10,15,12,94,low
10:00:00 AM,18,Wednesday,44,15,9,18,86,low
10:15:00 AM,18,Wednesday,43,7,25,11,86,low
10:30:00 AM,18,Wednesday,41,9,26,6,82,low
10:45:00 AM,18,Wednesday,32,2,6,30,70,low
11:00:00 AM,18,Wednesday,38,10,3,32,83,low
11:15:00 AM,18,Wednesday,56,10,9,35,110,high
11:30:00 AM,18,Wednesday,30,4,11,35,80,low
11:45:00 AM,18,Wednesday,66,2,3,26,97,low
12:00:00 PM,18,Wednesday,40,10,0,28,78,low
12:15:00 PM,18,Wednesday,50,8,8,25,91,low
12:30:00 PM,18,Wednesday,26,3,6,26,61,low
12:45:00 PM,18,Wednesday,50,8,7,33,98,low
01:00:00 PM,18,Wednesday,15,7,12,25,59,low
01:15:00 PM,18,Wednesday,57,17,14,28,116,high
01:30:00 PM,18,Wednesday,47,10,13,13,83,low
01:45:00 PM,18,Wednesday,12,4,11,23,50,normal
02:00:00 PM,18,Wednesday,49,8,4,16,77,low
02:15:00 PM,18,Wednesday,55,2,35,21,113,high
02:30:00 PM,18,Wednesday,44,9,10,26,89,low
02:45:00 PM,18,Wednesday,73,9,28,17,127,high
03:00:00 PM,18,Wednesday,36,4,26,12,78,low
03:15:00 PM,18,Wednesday,67,1,12,17,97,low
03:30:00 PM,18,Wednesday,44,16,17,11,88,low
03:45:00 PM,18,Wednesday,145,14,35,10,204,heavy
04:00:00 PM,18,Wednesday,107,10,32,10,159,heavy
04:15:00 PM,18,Wednesday,100,17,31,15,163,heavy
04:30:00 PM,18,Wednesday,126,20,37,10,193,heavy
04:45:00 PM,18,Wednesday,147,23,39,13,222,heavy
05:00:00 PM,18,Wednesday,133,6,18,10,167,heavy
05:15:00 PM,18,Wednesday,147,29,10,18,204,heavy
05:30:00 PM,18,Wednesday,115,11,27,13,166,heavy
05:45:00 PM,18,Wednesday,132,12,19,15,178,heavy
06:00:00 PM,18,Wednesday,106,23,20,13,162,heavy
06:15:00 PM,18,Wednesday,119,28,37,12,196,heavy
06:30:00 PM,18,Wednesday,77,18,10,14,119,high
06:45:00 PM,18,Wednesday,89,4,11,12,116,high
07:00:00 PM,18,Wednesday,106,5,13,17,141,high
07:15:00 PM,18,Wednesday,52,11,18,11,92,low
07:30:00 PM,18,Wednesday,84,7,9,19,119,high
07:45:00 PM,18,Wednesday,84,15,7,27,133,high
08:00:00 PM,18,Wednesday,93,0,11,27,131,high
08:15:00 PM,18,Wednesday,73,20,14,31,138,high
08:30:00 PM,18,Wednesday,50,16,5,32,103,high
08:45:00 PM,18,Wednesday,66,11,20,29,126,high
09:00:00 PM,18,Wednesday,63,8,6,13,90,low
09:15:00 PM,18,Wednesday,91,20,7,24,142,high
09:30:00 PM,18,Wednesday,104,5,12,22,143,high
09:45:00 PM,18,Wednesday,6,0,1,27,34,normal
10:00:00 PM,18,Wednesday,6,2,0,35,43,normal
10:15:00 PM,18,Wednesday,14,0,0,24,38,normal
10:30:00 PM,18,Wednesday,15,1,2,27,45,normal
10:45:00 PM,18,Wednesday,10,0,0,29,39,normal
11:00:00 PM,18,Wednesday,7,0,2,35,44,normal
11:15:00 PM,18,Wednesday,7,2,0,30,39,normal
11:30:00 PM,18,Wednesday,8,2,2,20,32,normal
11:45:00 PM,18,Wednesday,5,1,2,34,42,normal
12:00:00 AM,19,Thursday,7,2,1,31,41,normal
12:15:00 AM,19,Thursday,8,0,2,34,44,normal
12:30:00 AM,19,Thursday,6,0,1,26,33,normal
12:45:00 AM,19,Thursday,5,0,0,25,30,normal
01:00:00 AM,19,Thursday,11,1,1,25,38,normal
01:15:00 AM,19,Thursday,8,1,2,25,36,normal
01:30:00 AM,19,Thursday,15,2,2,38,57,normal
01:45:00 AM,19,Thursday,8,0,2,32,42,normal
02:00:00 AM,19,Thursday,7,0,0,32,39,normal
02:15:00 AM,19,Thursday,14,2,1,22,39,normal
02:30:00 AM,19,Thursday,14,2,2,32,50,normal
02:45:00 AM,19,Thursday,9,2,2,40,53,low
03:00:00 AM,19,Thursday,5,2,0,29,36,normal
03:15:00 AM,19,Thursday,11,1,1,32,45,normal
03:30:00 AM,19,Thursday,7,2,2,38,49,normal
03:45:00 AM,19,Thursday,7,0,1,33,41,normal
04:00:00 AM,19,Thursday,65,9,2,19,95,low
04:15:00 AM,19,Thursday,50,0,7,22,79,low
04:30:00 AM,19,Thursday,61,7,1,14,83,low
04:45:00 AM,19,Thursday,77,6,3,28,114,high
05:00:00 AM,19,Thursday,80,7,3,28,118,high
05:15:00 AM,19,Thursday,66,1,4,25,96,low
05:30:00 AM,19,Thursday,89,3,5,21,118,high
05:45:00 AM,19,Thursday,87,25,13,13,138,high
06:00:00 AM,19,Thursday,94,26,24,10,154,heavy
06:15:00 AM,19,Thursday,116,20,11,11,158,heavy
06:30:00 AM,19,Thursday,127,20,13,14,174,heavy
06:45:00 AM,19,Thursday,130,13,14,13,170,heavy
07:00:00 AM,19,Thursday,86,12,13,14,125,high
07:15:00 AM,19,Thursday,116,11,22,14,163,heavy
07:30:00 AM,19,Thursday,115,13,13,8,149,high
07:45:00 AM,19,Thursday,99,14,24,12,149,high
08:00:00 AM,19,Thursday,86,23,20,13,142,high
08:15:00 AM,19,Thursday,81,25,19,8,133,high
08:30:00 AM,19,Thursday,113,10,15,11,149,high
08:45:00 AM,19,Thursday,147,18,20,5,190,heavy
09:00:00 AM,19,Thursday,49,6,26,16,97,low
09:15:00 AM,19,Thursday,79,5,13,19,116,high
09:30:00 AM,19,Thursday,32,5,26,17,80,low
09:45:00 AM,19,Thursday,51,15,9,13,88,low
10:00:00 AM,19,Thursday,33,10,25,17,85,low
10:15:00 AM,19,Thursday,49,7,15,6,77,low
10:30:00 AM,19,Thursday,54,13,5,6,78,low
10:45:00 AM,19,Thursday,28,1,6,32,67,low
11:00:00 AM,19,Thursday,43,0,5,33,81,low
11:15:00 AM,19,Thursday,52,2,12,30,96,low
11:30:00 AM,19,Thursday,25,7,8,25,65,low
11:45:00 AM,19,Thursday,28,8,12,30,78,low
12:00:00 PM,19,Thursday,67,0,1,28,96,low
12:15:00 PM,19,Thursday,58,9,3,26,96,low
12:30:00 PM,19,Thursday,53,1,13,32,99,low
12:45:00 PM,19,Thursday,63,6,7,31,107,high
01:00:00 PM,19,Thursday,42,2,34,27,105,high
01:15:00 PM,19,Thursday,27,8,10,12,57,low
01:30:00 PM,19,Thursday,78,5,5,25,113,high
01:45:00 PM,19,Thursday,93,0,5,16,114,high
02:00:00 PM,19,Thursday,66,18,29,10,123,high
02:15:00 PM,19,Thursday,42,20,18,22,102,high
02:30:00 PM,19,Thursday,63,3,29,15,110,high
02:45:00 PM,19,Thursday,13,20,9,27,69,low
03:00:00 PM,19,Thursday,55,1,28,16,100,low
03:15:00 PM,19,Thursday,67,4,23,14,108,high
03:30:00 PM,19,Thursday,65,6,0,26,97,low
03:45:00 PM,19,Thursday,141,6,33,12,192,heavy
04:00:00 PM,19,Thursday,145,13,19,10,187,heavy
04:15:00 PM,19,Thursday,103,29,11,16,159,heavy
04:30:00 PM,19,Thursday,112,20,10,19,161,heavy
04:45:00 PM,19,Thursday,101,11,38,18,168,heavy
05:00:00 PM,19,Thursday,142,28,34,20,224,heavy
05:15:00 PM,19,Thursday,124,21,13,11,169,heavy
05:30:00 PM,19,Thursday,115,22,15,19,171,heavy
05:45:00 PM,19,Thursday,103,28,17,17,165,heavy
06:00:00 PM,19,Thursday,104,16,15,18,153,heavy
06:15:00 PM,19,Thursday,141,20,12,16,189,heavy
06:30:00 PM,19,Thursday,72,19,11,23,125,high
06:45:00 PM,19,Thursday,67,10,19,34,130,high
07:00:00 PM,19,Thursday,56,7,18,34,115,high
07:15:00 PM,19,Thursday,99,13,16,34,162,heavy
07:30:00 PM,19,Thursday,103,19,8,30,160,heavy
07:45:00 PM,19,Thursday,58,7,9,26,100,low
08:00:00 PM,19,Thursday,59,7,14,28,108,high
08:15:00 PM,19,Thursday,94,20,12,20,146,high
08:30:00 PM,19,Thursday,83,15,16,18,132,high
08:45:00 PM,19,Thursday,89,1,18,14,122,high
09:00:00 PM,19,Thursday,52,13,16,13,94,low
09:15:00 PM,19,Thursday,53,15,5,22,95,low
09:30:00 PM,19,Thursday,60,0,14,11,85,low
09:45:00 PM,19,Thursday,10,2,0,37,49,normal
10:00:00 PM,19,Thursday,11,1,2,33,47,normal
10:15:00 PM,19,Thursday,5,0,0,40,45,normal
10:30:00 PM,19,Thursday,11,1,0,31,43,normal
10:45:00 PM,19,Thursday,14,2,0,24,40,normal
11:00:00 PM,19,Thursday,10,0,2,26,38,normal
11:15:00 PM,19,Thursday,13,0,2,36,51,low
11:30:00 PM,19,Thursday,9,1,1,29,40,normal
11:45:00 PM,19,Thursday,10,0,2,22,34,normal
12:00:00 AM,20,Friday,13,2,0,26,41,normal
12:15:00 AM,20,Friday,7,2,1,21,31,normal
12:30:00 AM,20,Friday,8,1,0,40,49,normal
12:45:00 AM,20,Friday,10,2,0,20,32,normal
01:00:00 AM,20,Friday,13,0,2,22,37,normal
01:15:00 AM,20,Friday,15,2,1,40,58,low
01:30:00 AM,20,Friday,10,2,0,23,35,normal
01:45:00 AM,20,Friday,7,0,2,37,46,normal
02:00:00 AM,20,Friday,12,2,0,33,47,normal
02:15:00 AM,20,Friday,9,2,2,23,36,normal
02:30:00 AM,20,Friday,12,1,0,33,46,normal
02:45:00 AM,20,Friday,11,0,0,34,45,normal
03:00:00 AM,20,Friday,12,2,2,22,38,normal
03:15:00 AM,20,Friday,6,0,1,26,33,normal
03:30:00 AM,20,Friday,9,0,1,37,47,normal
03:45:00 AM,20,Friday,6,0,0,21,27,normal
04:00:00 AM,20,Friday,75,0,0,54,129,high
04:15:00 AM,20,Friday,60,9,2,50,121,high
04:30:00 AM,20,Friday,57,1,0,44,102,high
04:45:00 AM,20,Friday,64,10,5,26,105,high
05:00:00 AM,20,Friday,73,6,0,53,132,high
05:15:00 AM,20,Friday,62,6,4,39,111,high
05:30:00 AM,20,Friday,80,2,5,25,112,high
05:45:00 AM,20,Friday,25,6,5,40,76,normal
06:00:00 AM,20,Friday,73,6,3,43,125,low
06:15:00 AM,20,Friday,78,0,3,53,134,high
06:30:00 AM,20,Friday,32,6,4,27,69,low
06:45:00 AM,20,Friday,57,5,1,49,112,high
07:00:00 AM,20,Friday,36,2,3,60,101,high
07:15:00 AM,20,Friday,49,5,5,26,85,low
07:30:00 AM,20,Friday,70,9,0,28,107,high
07:45:00 AM,20,Friday,65,6,4,44,119,high
08:00:00 AM,20,Friday,53,8,0,40,101,high
08:15:00 AM,20,Friday,38,7,1,35,81,low
08:30:00 AM,20,Friday,68,10,5,55,138,high
08:45:00 AM,20,Friday,69,7,3,25,104,high
09:00:00 AM,20,Friday,136,49,19,10,214,heavy
09:15:00 AM,20,Friday,128,21,6,5,160,heavy
09:30:00 AM,20,Friday,138,37,15,7,197,heavy
09:45:00 AM,20,Friday,142,34,9,10,195,heavy
10:00:00 AM,20,Friday,109,23,19,8,159,heavy
10:15:00 AM,20,Friday,103,24,16,10,153,heavy
10:30:00 AM,20,Friday,140,34,6,7,187,heavy
10:45:00 AM,20,Friday,100,24,8,5,137,high
11:00:00 AM,20,Friday,128,24,20,7,179,heavy
11:15:00 AM,20,Friday,124,26,16,5,171,heavy
11:30:00 AM,20,Friday,150,44,13,7,214,heavy
11:45:00 AM,20,Friday,146,21,12,5,184,heavy
12:00:00 PM,20,Friday,146,50,13,9,218,heavy
12:15:00 PM,20,Friday,121,38,19,9,187,heavy
12:30:00 PM,20,Friday,150,42,20,5,217,heavy
12:45:00 PM,20,Friday,101,22,10,10,143,high
01:00:00 PM,20,Friday,127,22,9,7,165,heavy
01:15:00 PM,20,Friday,118,31,13,10,172,heavy
01:30:00 PM,20,Friday,106,47,12,9,174,heavy
01:45:00 PM,20,Friday,136,33,16,5,190,heavy
02:00:00 PM,20,Friday,114,25,20,7,166,heavy
02:15:00 PM,20,Friday,135,33,8,9,185,heavy
02:30:00 PM,20,Friday,125,33,12,10,180,heavy
02:45:00 PM,20,Friday,150,45,20,9,224,heavy
03:00:00 PM,20,Friday,85,14,2,9,110,high
03:15:00 PM,20,Friday,62,8,8,15,93,low
03:30:00 PM,20,Friday,68,9,15,15,107,high
03:45:00 PM,20,Friday,54,6,7,16,83,low
04:00:00 PM,20,Friday,70,5,7,14,96,low
04:15:00 PM,20,Friday,77,8,10,6,101,high
04:30:00 PM,20,Friday,90,6,15,17,128,high
04:45:00 PM,20,Friday,74,13,0,16,103,low
05:00:00 PM,20,Friday,74,9,2,11,96,low
05:15:00 PM,20,Friday,62,5,2,20,89,low
05:30:00 PM,20,Friday,66,12,8,16,102,low
05:45:00 PM,20,Friday,80,5,11,13,109,high
06:00:00 PM,20,Friday,75,13,15,12,115,high
06:15:00 PM,20,Friday,77,12,9,20,118,high
06:30:00 PM,20,Friday,84,10,3,15,112,high
06:45:00 PM,20,Friday,52,7,2,19,80,low
07:00:00 PM,20,Friday,32,2,0,32,66,low
07:15:00 PM,20,Friday,37,4,5,33,79,low
07:30:00 PM,20,Friday,39,1,5,29,74,low
07:45:00 PM,20,Friday,34,1,4,35,74,low
08:00:00 PM,20,Friday,43,3,2,41,89,low
08:15:00 PM,20,Friday,22,1,4,43,70,low
08:30:00 PM,20,Friday,43,4,1,27,75,low
08:45:00 PM,20,Friday,46,1,0,35,82,low
09:00:00 PM,20,Friday,42,2,5,42,91,low
09:15:00 PM,20,Friday,20,5,3,39,67,low
09:30:00 PM,20,Friday,40,5,3,26,74,low
09:45:00 PM,20,Friday,5,0,2,39,46,normal
10:00:00 PM,20,Friday,13,2,0,20,35,normal
10:15:00 PM,20,Friday,13,2,0,24,39,normal
10:30:00 PM,20,Friday,6,0,1,22,29,normal
10:45:00 PM,20,Friday,6,1,1,34,42,normal
11:00:00 PM,20,Friday,5,0,2,27,34,normal
11:15:00 PM,20,Friday,12,1,2,25,40,normal
11:30:00 PM,20,Friday,11,1,2,35,49,normal
11:45:00 PM,20,Friday,15,2,1,34,52,low
12:00:00 AM,21,Saturday,9,2,1,36,48,normal
12:15:00 AM,21,Saturday,12,0,2,32,46,normal
12:30:00 AM,21,Saturday,7,2,2,23,34,normal
12:45:00 AM,21,Saturday,12,1,1,33,47,normal
01:00:00 AM,21,Saturday,5,0,2,30,37,normal
01:15:00 AM,21,Saturday,12,1,2,27,42,normal
01:30:00 AM,21,Saturday,12,1,1,30,44,normal
01:45:00 AM,21,Saturday,15,1,0,34,50,normal
02:00:00 AM,21,Saturday,15,2,2,31,50,normal
02:15:00 AM,21,Saturday,13,0,1,29,43,normal
02:30:00 AM,21,Saturday,6,2,1,27,36,normal
02:45:00 AM,21,Saturday,13,0,0,30,43,normal
03:00:00 AM,21,Saturday,7,1,0,22,30,normal
03:15:00 AM,21,Saturday,8,1,0,28,37,normal
03:30:00 AM,21,Saturday,13,0,1,27,41,normal
03:45:00 AM,21,Saturday,6,1,0,33,40,normal
04:00:00 AM,21,Saturday,66,2,5,13,86,low
04:15:00 AM,21,Saturday,86,3,5,22,116,high
04:30:00 AM,21,Saturday,87,4,1,10,102,high
04:45:00 AM,21,Saturday,68,3,7,25,103,high
05:00:00 AM,21,Saturday,51,0,2,27,80,low
05:15:00 AM,21,Saturday,70,3,3,15,91,low
05:30:00 AM,21,Saturday,74,2,2,26,104,high
05:45:00 AM,21,Saturday,150,30,20,13,213,heavy
06:00:00 AM,21,Saturday,89,21,18,8,136,high
06:15:00 AM,21,Saturday,114,18,23,6,161,heavy
06:30:00 AM,21,Saturday,81,19,18,12,130,high
06:45:00 AM,21,Saturday,94,24,10,13,141,high
07:00:00 AM,21,Saturday,136,12,22,5,175,heavy
07:15:00 AM,21,Saturday,125,17,12,8,162,heavy
07:30:00 AM,21,Saturday,109,16,15,11,151,heavy
07:45:00 AM,21,Saturday,84,15,25,14,138,high
08:00:00 AM,21,Saturday,138,19,24,6,187,heavy
08:15:00 AM,21,Saturday,121,17,10,14,162,heavy
08:30:00 AM,21,Saturday,125,27,20,14,186,heavy
08:45:00 AM,21,Saturday,132,25,14,14,185,heavy
09:00:00 AM,21,Saturday,62,6,23,18,109,high
09:15:00 AM,21,Saturday,40,5,5,10,60,low
09:30:00 AM,21,Saturday,61,14,23,15,113,high
09:45:00 AM,21,Saturday,36,6,24,20,86,low
10:00:00 AM,21,Saturday,80,8,18,5,111,high
10:15:00 AM,21,Saturday,52,5,15,12,84,low
10:30:00 AM,21,Saturday,80,9,19,17,125,high
10:45:00 AM,21,Saturday,69,9,1,25,104,high
11:00:00 AM,21,Saturday,21,9,1,26,57,high
11:15:00 AM,21,Saturday,42,8,3,27,80,low
11:30:00 AM,21,Saturday,55,10,4,30,99,low
11:45:00 AM,21,Saturday,61,10,3,31,105,high
12:00:00 PM,21,Saturday,70,3,7,33,113,high
12:15:00 PM,21,Saturday,56,4,13,34,107,high
12:30:00 PM,21,Saturday,50,2,13,33,98,low
12:45:00 PM,21,Saturday,24,5,11,27,67,low
01:00:00 PM,21,Saturday,65,6,14,27,112,high
01:15:00 PM,21,Saturday,74,3,32,27,136,high
01:30:00 PM,21,Saturday,33,14,33,28,108,high
01:45:00 PM,21,Saturday,16,20,1,14,51,low
02:00:00 PM,21,Saturday,32,9,5,30,76,low
02:15:00 PM,21,Saturday,37,13,23,12,85,low
02:30:00 PM,21,Saturday,63,5,5,30,103,high
02:45:00 PM,21,Saturday,60,12,20,17,109,high
03:00:00 PM,21,Saturday,54,18,22,26,120,high
03:15:00 PM,21,Saturday,82,10,10,17,119,high
03:30:00 PM,21,Saturday,83,19,7,17,126,high
03:45:00 PM,21,Saturday,127,8,18,10,163,heavy
04:00:00 PM,21,Saturday,136,12,37,18,203,heavy
04:15:00 PM,21,Saturday,105,17,34,16,172,heavy
04:30:00 PM,21,Saturday,133,14,37,13,197,heavy
04:45:00 PM,21,Saturday,132,19,32,17,200,heavy
05:00:00 PM,21,Saturday,129,7,22,19,177,heavy
05:15:00 PM,21,Saturday,107,12,26,19,164,heavy
05:30:00 PM,21,Saturday,133,16,28,17,194,heavy
05:45:00 PM,21,Saturday,114,17,28,18,177,heavy
06:00:00 PM,21,Saturday,134,5,27,15,181,heavy
06:15:00 PM,21,Saturday,103,14,39,20,176,heavy
06:30:00 PM,21,Saturday,68,20,9,22,119,high
06:45:00 PM,21,Saturday,107,10,20,35,172,heavy
07:00:00 PM,21,Saturday,81,5,13,23,122,high
07:15:00 PM,21,Saturday,93,17,17,15,142,high
07:30:00 PM,21,Saturday,78,9,7,12,106,high
07:45:00 PM,21,Saturday,84,16,14,28,142,high
08:00:00 PM,21,Saturday,79,5,15,16,115,high
08:15:00 PM,21,Saturday,102,16,12,17,147,high
08:30:00 PM,21,Saturday,87,7,5,11,110,high
08:45:00 PM,21,Saturday,50,4,9,19,82,low
09:00:00 PM,21,Saturday,95,0,5,11,111,high
09:15:00 PM,21,Saturday,65,10,8,29,112,high
09:30:00 PM,21,Saturday,55,8,18,24,105,high
09:45:00 PM,21,Saturday,13,2,2,28,45,normal
10:00:00 PM,21,Saturday,6,1,1,31,39,normal
10:15:00 PM,21,Saturday,10,1,2,31,44,normal
10:30:00 PM,21,Saturday,13,1,1,40,55,normal
10:45:00 PM,21,Saturday,14,2,2,30,48,normal
11:00:00 PM,21,Saturday,6,1,0,39,46,normal
11:15:00 PM,21,Saturday,15,0,2,29,46,normal
11:30:00 PM,21,Saturday,8,2,2,24,36,normal
11:45:00 PM,21,Saturday,8,0,2,37,47,normal
12:00:00 AM,22,Sunday,11,0,1,24,36,normal
12:15:00 AM,22,Sunday,8,1,1,27,37,normal
12:30:00 AM,22,Sunday,6,1,1,33,41,normal
12:45:00 AM,22,Sunday,5,0,2,40,47,normal
01:00:00 AM,22,Sunday,8,2,1,35,46,normal
01:15:00 AM,22,Sunday,14,0,0,34,48,normal
01:30:00 AM,22,Sunday,14,1,1,21,37,normal
01:45:00 AM,22,Sunday,6,2,2,38,48,normal
02:00:00 AM,22,Sunday,8,2,2,36,48,normal
02:15:00 AM,22,Sunday,6,1,1,21,29,normal
02:30:00 AM,22,Sunday,6,0,2,40,48,normal
02:45:00 AM,22,Sunday,15,1,1,37,54,low
03:00:00 AM,22,Sunday,15,0,1,36,52,low
03:15:00 AM,22,Sunday,10,2,2,31,45,normal
03:30:00 AM,22,Sunday,8,1,2,38,49,normal
03:45:00 AM,22,Sunday,10,0,1,35,46,normal
04:00:00 AM,22,Sunday,58,2,1,19,80,low
04:15:00 AM,22,Sunday,70,4,0,14,88,low
04:30:00 AM,22,Sunday,72,8,4,18,102,high
04:45:00 AM,22,Sunday,88,8,1,28,125,high
05:00:00 AM,22,Sunday,57,10,4,26,97,low
05:15:00 AM,22,Sunday,61,7,6,24,98,low
05:30:00 AM,22,Sunday,65,6,4,27,102,high
05:45:00 AM,22,Sunday,131,30,19,5,185,heavy
06:00:00 AM,22,Sunday,117,21,21,11,170,heavy
06:15:00 AM,22,Sunday,145,26,14,9,194,heavy
06:30:00 AM,22,Sunday,85,16,16,6,123,high
06:45:00 AM,22,Sunday,92,19,24,5,140,high
07:00:00 AM,22,Sunday,130,19,13,9,171,heavy
07:15:00 AM,22,Sunday,84,12,19,15,130,high
07:30:00 AM,22,Sunday,115,17,19,13,164,high
07:45:00 AM,22,Sunday,119,17,15,12,163,high
08:00:00 AM,22,Sunday,99,20,14,14,147,high
08:15:00 AM,22,Sunday,102,30,24,6,162,heavy
08:30:00 AM,22,Sunday,86,29,10,5,130,high
08:45:00 AM,22,Sunday,128,25,13,10,176,heavy
09:00:00 AM,22,Sunday,40,12,20,12,84,low
09:15:00 AM,22,Sunday,56,7,15,12,90,low
09:30:00 AM,22,Sunday,46,9,10,15,80,low
09:45:00 AM,22,Sunday,49,6,11,14,80,low
10:00:00 AM,22,Sunday,62,6,19,15,102,high
10:15:00 AM,22,Sunday,42,6,16,7,71,low
10:30:00 AM,22,Sunday,45,11,5,20,81,low
10:45:00 AM,22,Sunday,21,0,5,27,53,low
11:00:00 AM,22,Sunday,38,7,4,26,75,low
11:15:00 AM,22,Sunday,25,10,12,27,74,low
11:30:00 AM,22,Sunday,36,0,8,28,72,low
11:45:00 AM,22,Sunday,41,7,7,30,85,low
12:00:00 PM,22,Sunday,64,0,1,26,91,low
12:15:00 PM,22,Sunday,62,3,6,29,100,low
12:30:00 PM,22,Sunday,66,10,13,35,124,high
12:45:00 PM,22,Sunday,34,5,7,26,72,low
01:00:00 PM,22,Sunday,84,3,0,12,99,low
01:15:00 PM,22,Sunday,18,2,30,10,60,low
01:30:00 PM,22,Sunday,40,9,17,25,91,low
01:45:00 PM,22,Sunday,68,18,13,24,123,high
02:00:00 PM,22,Sunday,56,18,22,21,117,high
02:15:00 PM,22,Sunday,28,4,29,17,78,low
02:30:00 PM,22,Sunday,18,0,27,12,57,low
02:45:00 PM,22,Sunday,77,16,33,16,142,high
03:00:00 PM,22,Sunday,67,8,32,11,118,high
03:15:00 PM,22,Sunday,33,9,33,24,99,low
03:30:00 PM,22,Sunday,77,6,9,18,110,high
03:45:00 PM,22,Sunday,104,5,14,15,138,high
04:00:00 PM,22,Sunday,130,17,27,10,184,heavy
04:15:00 PM,22,Sunday,149,17,11,19,196,heavy
04:30:00 PM,22,Sunday,132,20,39,15,206,heavy
04:45:00 PM,22,Sunday,147,24,34,18,223,heavy
05:00:00 PM,22,Sunday,111,11,14,14,150,high
05:15:00 PM,22,Sunday,136,19,37,14,206,heavy
05:30:00 PM,22,Sunday,120,5,34,18,177,heavy
05:45:00 PM,22,Sunday,126,16,15,20,177,heavy
06:00:00 PM,22,Sunday,125,5,34,18,182,heavy
06:15:00 PM,22,Sunday,128,6,13,19,166,heavy
06:30:00 PM,22,Sunday,99,14,5,30,148,heavy
06:45:00 PM,22,Sunday,107,20,6,20,153,heavy
07:00:00 PM,22,Sunday,104,3,12,20,139,heavy
07:15:00 PM,22,Sunday,61,8,17,10,96,low
07:30:00 PM,22,Sunday,78,10,13,23,124,high
07:45:00 PM,22,Sunday,51,4,8,11,74,low
08:00:00 PM,22,Sunday,84,3,20,16,123,high
08:15:00 PM,22,Sunday,99,1,17,12,129,high
08:30:00 PM,22,Sunday,88,20,15,35,158,heavy
08:45:00 PM,22,Sunday,97,4,13,10,124,high
09:00:00 PM,22,Sunday,94,3,5,33,135,high
09:15:00 PM,22,Sunday,68,1,13,32,114,high
09:30:00 PM,22,Sunday,73,9,19,27,128,high
09:45:00 PM,22,Sunday,10,2,1,28,41,normal
10:00:00 PM,22,Sunday,7,1,1,39,48,normal
10:15:00 PM,22,Sunday,6,1,2,36,45,normal
10:30:00 PM,22,Sunday,15,1,1,26,43,normal
10:45:00 PM,22,Sunday,8,0,2,39,49,normal
11:00:00 PM,22,Sunday,8,1,1,22,32,normal
11:15:00 PM,22,Sunday,5,0,0,28,33,normal
11:30:00 PM,22,Sunday,5,2,0,29,36,normal
11:45:00 PM,22,Sunday,11,2,1,35,49,normal
12:00:00 AM,23,Monday,15,1,0,37,53,low
12:15:00 AM,23,Monday,11,0,0,23,34,normal
12:30:00 AM,23,Monday,7,1,2,22,32,normal
12:45:00 AM,23,Monday,14,1,0,36,51,low
01:00:00 AM,23,Monday,12,2,2,36,52,low
01:15:00 AM,23,Monday,6,1,1,38,46,normal
01:30:00 AM,23,Monday,8,2,1,34,45,normal
01:45:00 AM,23,Monday,14,0,2,32,48,normal
02:00:00 AM,23,Monday,6,1,1,21,29,normal
02:15:00 AM,23,Monday,13,1,2,36,52,low
02:30:00 AM,23,Monday,9,2,0,39,50,normal
02:45:00 AM,23,Monday,6,1,1,37,45,normal
03:00:00 AM,23,Monday,8,2,1,27,38,normal
03:15:00 AM,23,Monday,7,1,2,23,33,normal
03:30:00 AM,23,Monday,5,1,1,21,28,normal
03:45:00 AM,23,Monday,5,2,1,35,43,normal
04:00:00 AM,23,Monday,63,10,5,13,91,low
04:15:00 AM,23,Monday,72,3,2,13,90,low
04:30:00 AM,23,Monday,56,5,7,24,92,low
04:45:00 AM,23,Monday,83,0,6,14,103,high
05:00:00 AM,23,Monday,88,0,2,15,105,high
05:15:00 AM,23,Monday,55,9,2,14,80,low
05:30:00 AM,23,Monday,86,1,4,11,102,high
05:45:00 AM,23,Monday,81,25,12,5,123,high
06:00:00 AM,23,Monday,104,18,14,9,145,high
06:15:00 AM,23,Monday,101,30,22,15,168,heavy
06:30:00 AM,23,Monday,123,30,20,8,181,heavy
06:45:00 AM,23,Monday,94,30,24,8,156,heavy
07:00:00 AM,23,Monday,142,10,16,8,176,heavy
07:15:00 AM,23,Monday,108,11,22,8,149,high
07:30:00 AM,23,Monday,100,25,19,5,149,high
07:45:00 AM,23,Monday,84,25,24,5,138,high
08:00:00 AM,23,Monday,125,19,23,7,174,heavy
08:15:00 AM,23,Monday,111,27,25,5,168,heavy
08:30:00 AM,23,Monday,110,21,23,5,159,heavy
08:45:00 AM,23,Monday,94,26,20,15,155,heavy
09:00:00 AM,23,Monday,55,10,5,8,78,low
09:15:00 AM,23,Monday,78,11,7,16,112,high
09:30:00 AM,23,Monday,50,11,13,15,89,low
09:45:00 AM,23,Monday,63,14,27,14,118,high
10:00:00 AM,23,Monday,76,11,9,17,113,high
10:15:00 AM,23,Monday,56,6,26,5,93,low
10:30:00 AM,23,Monday,32,13,8,11,64,low
10:45:00 AM,23,Monday,47,7,8,29,91,low
11:00:00 AM,23,Monday,30,9,0,31,70,low
11:15:00 AM,23,Monday,46,2,4,31,83,low
11:30:00 AM,23,Monday,52,2,5,29,88,low
11:45:00 AM,23,Monday,20,3,12,29,64,low
12:00:00 PM,23,Monday,47,2,10,28,87,low
12:15:00 PM,23,Monday,28,10,11,34,83,low
12:30:00 PM,23,Monday,54,2,11,26,93,low
12:45:00 PM,23,Monday,20,6,1,34,61,low
01:00:00 PM,23,Monday,53,13,7,15,88,low
01:15:00 PM,23,Monday,30,5,31,18,84,low
01:30:00 PM,23,Monday,72,15,6,10,103,high
01:45:00 PM,23,Monday,69,5,35,23,132,high
02:00:00 PM,23,Monday,38,15,8,15,76,low
02:15:00 PM,23,Monday,41,8,5,14,68,low
02:30:00 PM,23,Monday,8,8,29,30,75,low
02:45:00 PM,23,Monday,9,20,3,27,59,low
03:00:00 PM,23,Monday,58,9,24,18,109,high
03:15:00 PM,23,Monday,99,10,10,10,129,high
03:30:00 PM,23,Monday,40,18,9,20,87,low
03:45:00 PM,23,Monday,118,9,29,18,174,heavy
04:00:00 PM,23,Monday,104,27,15,10,156,heavy
04:15:00 PM,23,Monday,131,29,15,18,193,heavy
04:30:00 PM,23,Monday,128,14,22,20,184,heavy
04:45:00 PM,23,Monday,110,18,19,14,161,heavy
05:00:00 PM,23,Monday,116,26,22,18,182,heavy
05:15:00 PM,23,Monday,140,26,31,16,213,heavy
05:30:00 PM,23,Monday,141,27,23,16,207,heavy
05:45:00 PM,23,Monday,147,17,20,19,203,heavy
06:00:00 PM,23,Monday,137,23,25,10,195,heavy
06:15:00 PM,23,Monday,115,18,24,20,177,heavy
06:30:00 PM,23,Monday,83,3,12,27,125,high
06:45:00 PM,23,Monday,55,9,5,10,79,low
07:00:00 PM,23,Monday,99,16,14,35,164,heavy
07:15:00 PM,23,Monday,57,16,8,26,107,high
07:30:00 PM,23,Monday,65,11,17,28,121,high
07:45:00 PM,23,Monday,52,1,14,35,102,high
08:00:00 PM,23,Monday,60,8,9,27,104,high
08:15:00 PM,23,Monday,109,17,9,17,152,heavy
08:30:00 PM,23,Monday,71,6,20,33,130,high
08:45:00 PM,23,Monday,105,12,17,31,165,heavy
09:00:00 PM,23,Monday,72,18,18,25,133,high
09:15:00 PM,23,Monday,107,8,6,25,146,high
09:30:00 PM,23,Monday,86,13,14,20,133,high
09:45:00 PM,23,Monday,5,2,1,35,43,normal
10:00:00 PM,23,Monday,13,2,1,40,56,normal
10:15:00 PM,23,Monday,13,0,2,33,48,normal
10:30:00 PM,23,Monday,14,2,2,27,45,normal
10:45:00 PM,23,Monday,7,2,1,27,37,normal
11:00:00 PM,23,Monday,14,2,2,28,46,normal
11:15:00 PM,23,Monday,7,1,0,29,37,normal
11:30:00 PM,23,Monday,9,1,0,36,46,normal
11:45:00 PM,23,Monday,7,1,0,27,35,normal
12:00:00 AM,24,Tuesday,9,2,1,26,38,normal
12:15:00 AM,24,Tuesday,14,1,2,34,51,low
12:30:00 AM,24,Tuesday,13,2,2,21,38,normal
12:45:00 AM,24,Tuesday,6,0,0,21,27,normal
01:00:00 AM,24,Tuesday,5,1,1,28,35,normal
01:15:00 AM,24,Tuesday,14,0,0,31,45,normal
01:30:00 AM,24,Tuesday,8,0,1,39,48,normal
01:45:00 AM,24,Tuesday,6,2,2,24,34,normal
02:00:00 AM,24,Tuesday,9,1,0,33,43,normal
02:15:00 AM,24,Tuesday,11,1,2,40,54,low
02:30:00 AM,24,Tuesday,15,0,2,22,39,normal
02:45:00 AM,24,Tuesday,5,2,0,39,46,normal
03:00:00 AM,24,Tuesday,8,1,0,39,48,normal
03:15:00 AM,24,Tuesday,9,2,2,31,44,normal
03:30:00 AM,24,Tuesday,6,2,1,31,40,normal
03:45:00 AM,24,Tuesday,6,2,0,39,47,normal
04:00:00 AM,24,Tuesday,78,0,2,17,97,low
04:15:00 AM,24,Tuesday,77,7,6,28,118,high
04:30:00 AM,24,Tuesday,72,3,2,29,106,high
04:45:00 AM,24,Tuesday,87,2,3,21,113,high
05:00:00 AM,24,Tuesday,50,5,2,17,74,low
05:15:00 AM,24,Tuesday,79,9,5,14,107,high
05:30:00 AM,24,Tuesday,58,1,5,20,84,low
05:45:00 AM,24,Tuesday,94,12,16,8,130,high
06:00:00 AM,24,Tuesday,114,23,23,9,169,heavy
06:15:00 AM,24,Tuesday,94,24,23,6,147,high
06:30:00 AM,24,Tuesday,137,14,13,13,177,heavy
06:45:00 AM,24,Tuesday,80,17,24,10,131,high
07:00:00 AM,24,Tuesday,90,14,10,9,123,high
07:15:00 AM,24,Tuesday,105,10,14,15,144,high
07:30:00 AM,24,Tuesday,104,17,23,5,149,high
07:45:00 AM,24,Tuesday,135,30,17,10,192,heavy
08:00:00 AM,24,Tuesday,118,25,18,9,170,heavy
08:15:00 AM,24,Tuesday,96,13,21,6,136,high
08:30:00 AM,24,Tuesday,142,13,11,10,176,heavy
08:45:00 AM,24,Tuesday,128,30,15,14,187,heavy
09:00:00 AM,24,Tuesday,80,11,22,9,122,high
09:15:00 AM,24,Tuesday,79,13,21,15,128,high
09:30:00 AM,24,Tuesday,34,5,29,8,76,low
09:45:00 AM,24,Tuesday,58,14,5,5,82,low
10:00:00 AM,24,Tuesday,42,6,23,17,88,low
10:15:00 AM,24,Tuesday,63,9,19,18,109,high
10:30:00 AM,24,Tuesday,62,9,18,12,101,high
10:45:00 AM,24,Tuesday,44,7,11,32,94,low
11:00:00 AM,24,Tuesday,49,4,5,29,87,low
11:15:00 AM,24,Tuesday,67,10,1,33,111,high
11:30:00 AM,24,Tuesday,68,5,0,34,107,high
11:45:00 AM,24,Tuesday,23,5,10,32,70,low
12:00:00 PM,24,Tuesday,69,5,2,33,109,high
12:15:00 PM,24,Tuesday,37,9,2,34,82,low
12:30:00 PM,24,Tuesday,24,1,6,30,61,low
12:45:00 PM,24,Tuesday,60,1,4,29,94,low
01:00:00 PM,24,Tuesday,59,10,29,18,116,high
01:15:00 PM,24,Tuesday,69,4,20,14,107,high
01:30:00 PM,24,Tuesday,7,11,1,12,31,normal
01:45:00 PM,24,Tuesday,20,13,16,10,59,low
02:00:00 PM,24,Tuesday,61,16,1,14,92,low
02:15:00 PM,24,Tuesday,42,17,11,30,100,low
02:30:00 PM,24,Tuesday,28,11,32,14,85,low
02:45:00 PM,24,Tuesday,30,14,29,23,96,low
03:00:00 PM,24,Tuesday,36,1,24,21,82,low
03:15:00 PM,24,Tuesday,82,4,9,24,119,high
03:30:00 PM,24,Tuesday,72,2,27,16,117,high
03:45:00 PM,24,Tuesday,119,28,17,18,182,heavy
04:00:00 PM,24,Tuesday,124,26,26,15,191,heavy
04:15:00 PM,24,Tuesday,123,27,23,13,186,heavy
04:30:00 PM,24,Tuesday,129,20,32,20,201,heavy
04:45:00 PM,24,Tuesday,143,6,38,13,200,heavy
05:00:00 PM,24,Tuesday,109,9,28,19,165,heavy
05:15:00 PM,24,Tuesday,119,29,25,11,184,heavy
05:30:00 PM,24,Tuesday,120,19,16,16,171,heavy
05:45:00 PM,24,Tuesday,133,24,17,18,192,heavy
06:00:00 PM,24,Tuesday,132,23,29,13,197,heavy
06:15:00 PM,24,Tuesday,102,11,15,18,146,high
06:30:00 PM,24,Tuesday,73,8,10,21,112,high
06:45:00 PM,24,Tuesday,57,17,13,21,108,high
07:00:00 PM,24,Tuesday,94,17,7,17,135,high
07:15:00 PM,24,Tuesday,75,18,17,29,139,high
07:30:00 PM,24,Tuesday,58,15,17,16,106,high
07:45:00 PM,24,Tuesday,67,18,11,23,119,high
08:00:00 PM,24,Tuesday,59,14,9,10,92,low
08:15:00 PM,24,Tuesday,78,4,11,17,110,high
08:30:00 PM,24,Tuesday,106,13,18,29,166,heavy
08:45:00 PM,24,Tuesday,56,20,6,32,114,high
09:00:00 PM,24,Tuesday,59,0,11,35,105,high
09:15:00 PM,24,Tuesday,75,19,13,32,139,high
09:30:00 PM,24,Tuesday,85,6,5,21,117,high
09:45:00 PM,24,Tuesday,14,2,2,22,40,normal
10:00:00 PM,24,Tuesday,8,2,0,22,32,normal
10:15:00 PM,24,Tuesday,15,2,0,20,37,normal
10:30:00 PM,24,Tuesday,8,1,1,38,48,normal
10:45:00 PM,24,Tuesday,14,2,0,23,39,normal
11:00:00 PM,24,Tuesday,15,1,2,35,53,low
11:15:00 PM,24,Tuesday,14,2,1,31,48,normal
11:30:00 PM,24,Tuesday,9,1,0,32,42,normal
11:45:00 PM,24,Tuesday,12,1,0,24,37,normal
12:00:00 AM,25,Wednesday,11,1,2,29,43,normal
12:15:00 AM,25,Wednesday,7,0,1,27,35,normal
12:30:00 AM,25,Wednesday,14,0,2,35,51,low
12:45:00 AM,25,Wednesday,10,1,1,38,50,normal
01:00:00 AM,25,Wednesday,10,1,0,27,38,normal
01:15:00 AM,25,Wednesday,13,0,1,34,48,normal
01:30:00 AM,25,Wednesday,13,1,1,20,35,normal
01:45:00 AM,25,Wednesday,15,1,0,32,48,normal
02:00:00 AM,25,Wednesday,7,0,0,32,39,normal
02:15:00 AM,25,Wednesday,13,0,2,37,52,low
02:30:00 AM,25,Wednesday,8,0,0,39,47,normal
02:45:00 AM,25,Wednesday,11,1,2,37,51,low
03:00:00 AM,25,Wednesday,11,0,0,37,48,normal
03:15:00 AM,25,Wednesday,10,1,2,26,39,normal
03:30:00 AM,25,Wednesday,15,1,1,36,53,low
03:45:00 AM,25,Wednesday,9,0,2,34,45,normal
04:00:00 AM,25,Wednesday,60,3,6,23,92,low
04:15:00 AM,25,Wednesday,51,7,3,22,83,low
04:30:00 AM,25,Wednesday,60,7,2,27,96,low
04:45:00 AM,25,Wednesday,65,0,3,25,93,low
05:00:00 AM,25,Wednesday,66,4,1,21,92,low
05:15:00 AM,25,Wednesday,63,3,5,30,101,high
05:30:00 AM,25,Wednesday,72,7,2,20,101,high
05:45:00 AM,25,Wednesday,124,16,21,8,169,heavy
06:00:00 AM,25,Wednesday,106,17,22,14,159,heavy
06:15:00 AM,25,Wednesday,91,24,10,15,140,high
06:30:00 AM,25,Wednesday,120,10,18,10,158,heavy
06:45:00 AM,25,Wednesday,147,20,25,8,200,heavy
07:00:00 AM,25,Wednesday,126,30,19,8,183,heavy
07:15:00 AM,25,Wednesday,102,19,22,9,152,heavy
07:30:00 AM,25,Wednesday,87,15,25,14,141,high
07:45:00 AM,25,Wednesday,118,24,17,15,174,heavy
08:00:00 AM,25,Wednesday,144,18,16,5,183,heavy
08:15:00 AM,25,Wednesday,85,12,23,7,127,high
08:30:00 AM,25,Wednesday,81,23,19,12,135,high
08:45:00 AM,25,Wednesday,121,16,25,9,171,heavy
09:00:00 AM,25,Wednesday,36,14,17,6,73,low
09:15:00 AM,25,Wednesday,80,15,24,11,130,high
09:30:00 AM,25,Wednesday,53,12,22,8,95,low
09:45:00 AM,25,Wednesday,74,7,8,20,109,high
10:00:00 AM,25,Wednesday,53,11,17,13,94,low
10:15:00 AM,25,Wednesday,56,6,10,9,81,low
10:30:00 AM,25,Wednesday,66,14,18,13,111,high
10:45:00 AM,25,Wednesday,68,10,5,31,114,high
11:00:00 AM,25,Wednesday,24,1,10,29,64,low
11:15:00 AM,25,Wednesday,52,4,10,31,97,low
11:30:00 AM,25,Wednesday,35,5,12,34,86,low
11:45:00 AM,25,Wednesday,47,1,5,33,86,low
12:00:00 PM,25,Wednesday,36,6,2,35,79,low
12:15:00 PM,25,Wednesday,61,7,5,26,99,low
12:30:00 PM,25,Wednesday,57,10,2,35,104,high
12:45:00 PM,25,Wednesday,64,10,9,29,112,high
01:00:00 PM,25,Wednesday,31,16,23,10,80,low
01:15:00 PM,25,Wednesday,91,2,0,11,104,high
01:30:00 PM,25,Wednesday,16,12,26,24,78,low
01:45:00 PM,25,Wednesday,58,18,13,25,114,high
02:00:00 PM,25,Wednesday,86,16,12,16,130,high
02:15:00 PM,25,Wednesday,81,8,20,12,121,high
02:30:00 PM,25,Wednesday,6,9,14,29,58,normal
02:45:00 PM,25,Wednesday,26,0,9,19,54,low
03:00:00 PM,25,Wednesday,23,15,7,12,57,low
03:15:00 PM,25,Wednesday,79,5,15,13,112,high
03:30:00 PM,25,Wednesday,11,7,10,29,57,low
03:45:00 PM,25,Wednesday,134,22,29,11,196,heavy
04:00:00 PM,25,Wednesday,128,23,24,16,191,heavy
04:15:00 PM,25,Wednesday,106,22,19,18,165,heavy
04:30:00 PM,25,Wednesday,124,11,30,18,183,heavy
04:45:00 PM,25,Wednesday,134,10,13,19,176,heavy
05:00:00 PM,25,Wednesday,125,17,10,16,168,heavy
05:15:00 PM,25,Wednesday,147,18,13,11,189,heavy
05:30:00 PM,25,Wednesday,100,10,20,16,146,high
05:45:00 PM,25,Wednesday,146,17,25,11,199,heavy
06:00:00 PM,25,Wednesday,142,15,34,10,201,heavy
06:15:00 PM,25,Wednesday,130,24,23,10,187,heavy
06:30:00 PM,25,Wednesday,94,15,15,32,156,heavy
06:45:00 PM,25,Wednesday,104,7,6,19,136,high
07:00:00 PM,25,Wednesday,93,10,19,26,148,high
07:15:00 PM,25,Wednesday,51,8,13,17,89,low
07:30:00 PM,25,Wednesday,97,7,7,26,137,high
07:45:00 PM,25,Wednesday,93,16,16,28,153,heavy
08:00:00 PM,25,Wednesday,105,17,17,12,151,heavy
08:15:00 PM,25,Wednesday,66,12,20,31,129,high
08:30:00 PM,25,Wednesday,56,16,20,28,120,high
08:45:00 PM,25,Wednesday,109,20,8,13,150,high
09:00:00 PM,25,Wednesday,64,8,14,20,106,high
09:15:00 PM,25,Wednesday,83,6,6,35,130,high
09:30:00 PM,25,Wednesday,107,16,14,26,163,heavy
09:45:00 PM,25,Wednesday,5,1,0,28,34,normal
10:00:00 PM,25,Wednesday,5,2,1,20,28,normal
10:15:00 PM,25,Wednesday,12,1,2,38,53,low
10:30:00 PM,25,Wednesday,6,0,1,24,31,normal
10:45:00 PM,25,Wednesday,5,1,2,21,29,normal
11:00:00 PM,25,Wednesday,15,2,1,31,49,normal
11:15:00 PM,25,Wednesday,5,0,0,31,36,normal
11:30:00 PM,25,Wednesday,8,0,1,29,38,normal
11:45:00 PM,25,Wednesday,12,1,1,36,50,normal
12:00:00 AM,26,Thursday,14,1,2,36,53,low
12:15:00 AM,26,Thursday,11,2,2,26,41,normal
12:30:00 AM,26,Thursday,8,2,2,29,41,normal
12:45:00 AM,26,Thursday,10,1,2,36,49,normal
01:00:00 AM,26,Thursday,12,1,1,30,44,normal
01:15:00 AM,26,Thursday,6,1,0,25,32,normal
01:30:00 AM,26,Thursday,7,1,1,21,30,normal
01:45:00 AM,26,Thursday,5,2,2,20,29,normal
02:00:00 AM,26,Thursday,9,2,0,21,32,normal
02:15:00 AM,26,Thursday,5,1,2,35,43,normal
02:30:00 AM,26,Thursday,14,0,2,28,44,normal
02:45:00 AM,26,Thursday,12,1,1,39,53,low
03:00:00 AM,26,Thursday,7,0,0,29,36,normal
03:15:00 AM,26,Thursday,10,2,0,22,34,normal
03:30:00 AM,26,Thursday,13,1,1,22,37,normal
03:45:00 AM,26,Thursday,15,1,1,39,56,low
04:00:00 AM,26,Thursday,79,3,1,14,97,low
04:15:00 AM,26,Thursday,58,3,2,18,81,low
04:30:00 AM,26,Thursday,60,8,5,23,96,low
04:45:00 AM,26,Thursday,89,1,0,29,119,high
05:00:00 AM,26,Thursday,64,4,0,12,80,low
05:15:00 AM,26,Thursday,62,5,3,26,96,low
05:30:00 AM,26,Thursday,79,7,7,11,104,high
05:45:00 AM,26,Thursday,92,12,19,8,131,high
06:00:00 AM,26,Thursday,111,27,12,13,163,heavy
06:15:00 AM,26,Thursday,105,25,24,11,165,heavy
06:30:00 AM,26,Thursday,84,26,12,11,133,high
06:45:00 AM,26,Thursday,130,19,20,11,180,heavy
07:00:00 AM,26,Thursday,107,16,16,9,148,high
07:15:00 AM,26,Thursday,130,15,11,15,171,heavy
07:30:00 AM,26,Thursday,139,28,17,5,189,heavy
07:45:00 AM,26,Thursday,91,17,25,14,147,high
08:00:00 AM,26,Thursday,139,22,16,5,182,heavy
08:15:00 AM,26,Thursday,141,11,19,7,178,heavy
08:30:00 AM,26,Thursday,116,29,14,12,171,heavy
08:45:00 AM,26,Thursday,80,17,20,13,130,high
09:00:00 AM,26,Thursday,59,10,23,19,111,high
09:15:00 AM,26,Thursday,76,15,25,5,121,high
09:30:00 AM,26,Thursday,42,10,15,7,74,low
09:45:00 AM,26,Thursday,31,5,27,10,73,low
10:00:00 AM,26,Thursday,40,12,26,11,89,low
10:15:00 AM,26,Thursday,72,15,7,19,113,high
10:30:00 AM,26,Thursday,37,8,15,15,75,low
10:45:00 AM,26,Thursday,54,6,0,27,87,low
11:00:00 AM,26,Thursday,21,0,1,25,47,low
11:15:00 AM,26,Thursday,70,9,6,30,115,high
11:30:00 AM,26,Thursday,38,3,2,33,76,low
11:45:00 AM,26,Thursday,23,0,1,32,56,low
12:00:00 PM,26,Thursday,38,5,11,33,87,low
12:15:00 PM,26,Thursday,57,9,1,31,98,low
12:30:00 PM,26,Thursday,20,3,3,27,53,low
12:45:00 PM,26,Thursday,42,6,9,33,90,low
01:00:00 PM,26,Thursday,47,11,21,15,94,low
01:15:00 PM,26,Thursday,67,8,22,22,119,high
01:30:00 PM,26,Thursday,70,8,28,13,119,high
01:45:00 PM,26,Thursday,53,7,32,11,103,high
02:00:00 PM,26,Thursday,14,19,25,30,88,low
02:15:00 PM,26,Thursday,85,16,26,26,153,high
02:30:00 PM,26,Thursday,84,11,34,14,143,high
02:45:00 PM,26,Thursday,59,14,33,12,118,high
03:00:00 PM,26,Thursday,94,3,12,14,123,high
03:15:00 PM,26,Thursday,81,18,25,12,136,high
03:30:00 PM,26,Thursday,91,12,10,25,138,high
03:45:00 PM,26,Thursday,107,23,13,11,154,high
04:00:00 PM,26,Thursday,137,20,30,15,202,heavy
04:15:00 PM,26,Thursday,121,14,32,10,177,heavy
04:30:00 PM,26,Thursday,115,26,33,19,193,heavy
04:45:00 PM,26,Thursday,133,25,19,12,189,heavy
05:00:00 PM,26,Thursday,110,10,29,17,166,heavy
05:15:00 PM,26,Thursday,110,20,24,17,171,heavy
05:30:00 PM,26,Thursday,111,26,14,15,166,heavy
05:45:00 PM,26,Thursday,113,20,38,17,188,heavy
06:00:00 PM,26,Thursday,134,13,29,15,191,heavy
06:15:00 PM,26,Thursday,148,14,21,19,202,heavy
06:30:00 PM,26,Thursday,92,15,18,18,143,high
06:45:00 PM,26,Thursday,71,2,17,10,100,low
07:00:00 PM,26,Thursday,61,0,17,25,103,high
07:15:00 PM,26,Thursday,85,6,11,25,127,high
07:30:00 PM,26,Thursday,79,11,8,16,114,high
07:45:00 PM,26,Thursday,80,17,11,17,125,high
08:00:00 PM,26,Thursday,95,5,7,22,129,high
08:15:00 PM,26,Thursday,108,1,15,25,149,high
08:30:00 PM,26,Thursday,55,20,11,25,111,high
08:45:00 PM,26,Thursday,56,8,19,27,110,high
09:00:00 PM,26,Thursday,57,14,6,34,111,high
09:15:00 PM,26,Thursday,90,11,10,27,138,high
09:30:00 PM,26,Thursday,109,20,6,18,153,high
09:45:00 PM,26,Thursday,11,2,2,39,54,low
10:00:00 PM,26,Thursday,13,1,1,25,40,normal
10:15:00 PM,26,Thursday,5,2,1,26,34,normal
10:30:00 PM,26,Thursday,5,1,1,33,40,normal
10:45:00 PM,26,Thursday,7,2,0,37,46,normal
11:00:00 PM,26,Thursday,10,2,1,32,45,normal
11:15:00 PM,26,Thursday,11,0,0,26,37,normal
11:30:00 PM,26,Thursday,10,0,1,37,48,normal
11:45:00 PM,26,Thursday,13,1,1,21,36,normal
12:00:00 AM,27,Friday,5,2,2,32,41,normal
12:15:00 AM,27,Friday,14,1,1,33,49,normal
12:30:00 AM,27,Friday,10,0,0,30,40,normal
12:45:00 AM,27,Friday,15,0,1,38,54,low
01:00:00 AM,27,Friday,11,2,0,34,47,normal
01:15:00 AM,27,Friday,8,2,0,39,49,normal
01:30:00 AM,27,Friday,8,2,1,40,51,low
01:45:00 AM,27,Friday,10,1,2,33,46,normal
02:00:00 AM,27,Friday,13,1,2,37,53,low
02:15:00 AM,27,Friday,5,1,0,38,44,normal
02:30:00 AM,27,Friday,10,1,1,30,42,normal
02:45:00 AM,27,Friday,6,1,2,23,32,normal
03:00:00 AM,27,Friday,6,2,2,22,32,normal
03:15:00 AM,27,Friday,6,2,0,30,38,normal
03:30:00 AM,27,Friday,9,2,0,37,48,normal
03:45:00 AM,27,Friday,11,2,2,34,49,normal
04:00:00 AM,27,Friday,31,0,4,57,92,low
04:15:00 AM,27,Friday,29,2,4,37,72,low
04:30:00 AM,27,Friday,76,0,5,40,121,high
04:45:00 AM,27,Friday,51,6,5,57,119,high
05:00:00 AM,27,Friday,69,1,0,51,121,high
05:15:00 AM,27,Friday,42,7,2,47,98,low
05:30:00 AM,27,Friday,42,10,1,47,100,low
05:45:00 AM,27,Friday,38,8,2,57,105,high
06:00:00 AM,27,Friday,25,9,3,39,76,low
06:15:00 AM,27,Friday,72,0,4,36,112,high
06:30:00 AM,27,Friday,78,8,5,37,128,high
06:45:00 AM,27,Friday,45,7,0,35,87,low
07:00:00 AM,27,Friday,75,6,2,42,125,high
07:15:00 AM,27,Friday,77,7,1,57,142,high
07:30:00 AM,27,Friday,34,3,2,47,86,low
07:45:00 AM,27,Friday,49,4,2,58,113,high
08:00:00 AM,27,Friday,40,4,2,57,103,high
08:15:00 AM,27,Friday,44,9,5,56,114,high
08:30:00 AM,27,Friday,70,0,2,26,98,low
08:45:00 AM,27,Friday,63,7,0,52,122,high
09:00:00 AM,27,Friday,126,21,7,6,160,heavy
09:15:00 AM,27,Friday,117,38,11,9,175,heavy
09:30:00 AM,27,Friday,101,41,17,9,168,heavy
09:45:00 AM,27,Friday,125,35,19,7,186,heavy
10:00:00 AM,27,Friday,147,43,10,7,207,heavy
10:15:00 AM,27,Friday,140,22,18,5,185,heavy
10:30:00 AM,27,Friday,142,44,6,6,198,heavy
10:45:00 AM,27,Friday,147,45,8,10,210,heavy
11:00:00 AM,27,Friday,137,26,14,8,185,heavy
11:15:00 AM,27,Friday,129,40,13,5,187,heavy
11:30:00 AM,27,Friday,131,30,9,8,178,heavy
11:45:00 AM,27,Friday,107,40,6,6,159,normal
12:00:00 PM,27,Friday,102,37,16,7,162,normal
12:15:00 PM,27,Friday,122,46,15,8,191,heavy
12:30:00 PM,27,Friday,116,30,15,7,168,heavy
12:45:00 PM,27,Friday,136,28,20,9,193,heavy
01:00:00 PM,27,Friday,138,34,15,10,197,heavy
01:15:00 PM,27,Friday,131,21,9,9,170,heavy
01:30:00 PM,27,Friday,129,39,16,5,189,heavy
01:45:00 PM,27,Friday,118,50,18,5,191,heavy
02:00:00 PM,27,Friday,140,40,8,6,194,heavy
02:15:00 PM,27,Friday,137,29,10,9,185,heavy
02:30:00 PM,27,Friday,121,46,5,6,178,heavy
02:45:00 PM,27,Friday,120,25,10,6,161,normal
03:00:00 PM,27,Friday,72,10,13,17,112,high
03:15:00 PM,27,Friday,83,11,9,16,119,high
03:30:00 PM,27,Friday,67,6,12,19,104,high
03:45:00 PM,27,Friday,75,8,7,8,98,low
04:00:00 PM,27,Friday,60,10,6,5,81,low
04:15:00 PM,27,Friday,57,13,2,12,84,low
04:30:00 PM,27,Friday,77,13,7,12,109,high
04:45:00 PM,27,Friday,64,11,0,9,84,low
05:00:00 PM,27,Friday,85,12,12,19,128,high
05:15:00 PM,27,Friday,88,5,2,5,100,low
05:30:00 PM,27,Friday,83,14,4,18,119,high
05:45:00 PM,27,Friday,64,6,1,13,84,low
06:00:00 PM,27,Friday,62,9,0,18,89,low
06:15:00 PM,27,Friday,69,8,0,15,92,low
06:30:00 PM,27,Friday,84,15,5,18,122,high
06:45:00 PM,27,Friday,70,6,9,8,93,low
07:00:00 PM,27,Friday,30,0,1,30,61,low
07:15:00 PM,27,Friday,29,3,3,30,65,low
07:30:00 PM,27,Friday,27,0,1,33,61,low
07:45:00 PM,27,Friday,41,3,3,40,87,low
08:00:00 PM,27,Friday,29,3,1,35,68,low
08:15:00 PM,27,Friday,38,0,1,28,67,low
08:30:00 PM,27,Friday,29,2,1,27,59,low
08:45:00 PM,27,Friday,39,4,0,36,79,low
09:00:00 PM,27,Friday,27,1,5,31,64,low
09:15:00 PM,27,Friday,42,5,5,26,78,low
09:30:00 PM,27,Friday,31,1,3,38,73,low
09:45:00 PM,27,Friday,7,0,0,35,42,normal
10:00:00 PM,27,Friday,13,0,1,40,54,low
10:15:00 PM,27,Friday,11,2,2,25,40,normal
10:30:00 PM,27,Friday,11,0,0,31,42,normal
10:45:00 PM,27,Friday,6,2,2,23,33,normal
11:00:00 PM,27,Friday,5,2,2,26,35,normal
11:15:00 PM,27,Friday,13,1,2,26,42,normal
11:30:00 PM,27,Friday,13,1,2,39,55,low
11:45:00 PM,27,Friday,14,2,2,28,46,normal
12:00:00 AM,28,Saturday,5,0,2,39,46,normal
12:15:00 AM,28,Saturday,5,1,1,40,47,normal
12:30:00 AM,28,Saturday,13,2,1,38,54,low
12:45:00 AM,28,Saturday,9,1,0,29,39,normal
01:00:00 AM,28,Saturday,11,0,1,27,39,normal
01:15:00 AM,28,Saturday,8,0,2,33,43,normal
01:30:00 AM,28,Saturday,9,0,2,40,51,low
01:45:00 AM,28,Saturday,12,1,0,37,50,normal
02:00:00 AM,28,Saturday,7,2,2,23,34,normal
02:15:00 AM,28,Saturday,14,1,1,29,45,normal
02:30:00 AM,28,Saturday,13,1,2,38,54,low
02:45:00 AM,28,Saturday,11,2,2,37,52,low
03:00:00 AM,28,Saturday,10,2,2,26,40,normal
03:15:00 AM,28,Saturday,12,0,2,21,35,normal
03:30:00 AM,28,Saturday,12,2,1,21,36,normal
03:45:00 AM,28,Saturday,6,2,1,38,47,normal
04:00:00 AM,28,Saturday,72,6,1,25,104,high
04:15:00 AM,28,Saturday,77,5,6,20,108,high
04:30:00 AM,28,Saturday,89,10,0,16,115,high
04:45:00 AM,28,Saturday,86,1,6,28,121,high
05:00:00 AM,28,Saturday,64,1,0,27,92,low
05:15:00 AM,28,Saturday,55,3,1,27,86,low
05:30:00 AM,28,Saturday,59,0,6,16,81,low
05:45:00 AM,28,Saturday,135,13,24,6,178,heavy
06:00:00 AM,28,Saturday,138,21,19,10,188,heavy
06:15:00 AM,28,Saturday,80,10,17,13,120,high
06:30:00 AM,28,Saturday,148,24,14,10,196,heavy
06:45:00 AM,28,Saturday,84,25,21,10,140,high
07:00:00 AM,28,Saturday,103,19,15,6,143,high
07:15:00 AM,28,Saturday,119,13,10,9,151,heavy
07:30:00 AM,28,Saturday,110,16,21,8,155,heavy
07:45:00 AM,28,Saturday,130,18,20,13,181,heavy
08:00:00 AM,28,Saturday,105,27,23,10,165,heavy
08:15:00 AM,28,Saturday,103,30,22,12,167,heavy
08:30:00 AM,28,Saturday,150,12,16,10,188,heavy
08:45:00 AM,28,Saturday,132,15,17,14,178,heavy
09:00:00 AM,28,Saturday,47,6,15,9,77,low
09:15:00 AM,28,Saturday,71,10,6,10,97,low
09:30:00 AM,28,Saturday,49,10,12,8,79,low
09:45:00 AM,28,Saturday,43,6,21,5,75,low
10:00:00 AM,28,Saturday,74,15,29,15,133,high
10:15:00 AM,28,Saturday,30,6,26,18,80,low
10:30:00 AM,28,Saturday,38,15,17,15,85,low
10:45:00 AM,28,Saturday,59,2,8,25,94,low
11:00:00 AM,28,Saturday,51,8,5,25,89,low
11:15:00 AM,28,Saturday,26,9,11,29,75,low
11:30:00 AM,28,Saturday,55,7,8,33,103,high
11:45:00 AM,28,Saturday,43,4,0,32,79,low
12:00:00 PM,28,Saturday,64,1,7,35,107,high
12:15:00 PM,28,Saturday,63,8,13,27,111,high
12:30:00 PM,28,Saturday,42,8,3,26,79,low
12:45:00 PM,28,Saturday,30,7,10,32,79,low
01:00:00 PM,28,Saturday,13,20,1,20,54,low
01:15:00 PM,28,Saturday,59,19,16,23,117,high
01:30:00 PM,28,Saturday,57,14,21,19,111,high
01:45:00 PM,28,Saturday,74,11,23,19,127,high
02:00:00 PM,28,Saturday,33,3,27,23,86,low
02:15:00 PM,28,Saturday,7,6,12,20,45,normal
02:30:00 PM,28,Saturday,38,7,1,13,59,low
02:45:00 PM,28,Saturday,6,9,10,27,52,low
03:00:00 PM,28,Saturday,54,6,18,23,101,high
03:15:00 PM,28,Saturday,45,16,28,18,107,high
03:30:00 PM,28,Saturday,44,3,0,23,70,low
03:45:00 PM,28,Saturday,144,21,10,19,194,heavy
04:00:00 PM,28,Saturday,144,24,26,14,208,heavy
04:15:00 PM,28,Saturday,112,26,38,12,188,heavy
04:30:00 PM,28,Saturday,106,9,31,11,157,heavy
04:45:00 PM,28,Saturday,149,27,33,16,225,heavy
05:00:00 PM,28,Saturday,120,30,17,19,186,heavy
05:15:00 PM,28,Saturday,133,15,10,10,168,heavy
05:30:00 PM,28,Saturday,108,14,38,19,179,heavy
05:45:00 PM,28,Saturday,141,24,11,19,195,heavy
06:00:00 PM,28,Saturday,127,15,21,17,180,heavy
06:15:00 PM,28,Saturday,134,20,38,20,212,heavy
06:30:00 PM,28,Saturday,95,16,15,24,150,high
06:45:00 PM,28,Saturday,71,4,14,30,119,high
07:00:00 PM,28,Saturday,70,7,7,10,94,low
07:15:00 PM,28,Saturday,55,13,10,33,111,high
07:30:00 PM,28,Saturday,74,19,12,35,140,high
07:45:00 PM,28,Saturday,57,4,15,29,105,high
08:00:00 PM,28,Saturday,59,11,5,21,96,low
08:15:00 PM,28,Saturday,85,8,14,15,122,high
08:30:00 PM,28,Saturday,74,20,17,24,135,high
08:45:00 PM,28,Saturday,88,19,7,27,141,high
09:00:00 PM,28,Saturday,64,18,13,17,112,high
09:15:00 PM,28,Saturday,80,18,14,11,123,high
09:30:00 PM,28,Saturday,108,7,11,25,151,heavy
09:45:00 PM,28,Saturday,14,1,0,28,43,normal
10:00:00 PM,28,Saturday,7,1,1,33,42,normal
10:15:00 PM,28,Saturday,5,1,2,31,39,normal
10:30:00 PM,28,Saturday,11,2,0,36,49,normal
10:45:00 PM,28,Saturday,14,2,1,40,57,low
11:00:00 PM,28,Saturday,6,0,1,21,28,normal
11:15:00 PM,28,Saturday,7,0,2,36,45,normal
11:30:00 PM,28,Saturday,12,2,1,20,35,normal
11:45:00 PM,28,Saturday,8,2,2,39,51,low
12:00:00 AM,29,Sunday,5,1,0,35,41,normal
12:15:00 AM,29,Sunday,5,2,1,21,29,normal
12:30:00 AM,29,Sunday,10,0,2,33,45,normal
12:45:00 AM,29,Sunday,12,0,0,35,47,normal
01:00:00 AM,29,Sunday,11,0,2,37,50,normal
01:15:00 AM,29,Sunday,6,0,0,29,35,normal
01:30:00 AM,29,Sunday,15,2,1,38,56,normal
01:45:00 AM,29,Sunday,13,1,2,20,36,normal
02:00:00 AM,29,Sunday,11,2,2,39,54,low
02:15:00 AM,29,Sunday,6,1,0,39,46,normal
02:30:00 AM,29,Sunday,6,0,1,28,35,normal
02:45:00 AM,29,Sunday,15,2,1,37,55,low
03:00:00 AM,29,Sunday,11,2,2,24,39,normal
03:15:00 AM,29,Sunday,5,0,0,21,26,normal
03:30:00 AM,29,Sunday,8,0,0,20,28,normal
03:45:00 AM,29,Sunday,8,1,2,29,40,normal
04:00:00 AM,29,Sunday,54,8,7,16,85,low
04:15:00 AM,29,Sunday,64,0,1,25,90,normal
04:30:00 AM,29,Sunday,55,2,6,24,87,normal
04:45:00 AM,29,Sunday,86,4,5,20,115,high
05:00:00 AM,29,Sunday,51,10,3,28,92,low
05:15:00 AM,29,Sunday,81,8,5,12,106,high
05:30:00 AM,29,Sunday,73,1,3,23,100,low
05:45:00 AM,29,Sunday,104,29,19,13,165,heavy
06:00:00 AM,29,Sunday,122,17,21,9,169,heavy
06:15:00 AM,29,Sunday,94,21,15,7,137,high
06:30:00 AM,29,Sunday,141,30,22,11,204,heavy
06:45:00 AM,29,Sunday,93,12,25,7,137,high
07:00:00 AM,29,Sunday,123,29,13,7,172,heavy
07:15:00 AM,29,Sunday,131,27,19,15,192,heavy
07:30:00 AM,29,Sunday,138,25,20,14,197,heavy
07:45:00 AM,29,Sunday,148,20,14,11,193,heavy
08:00:00 AM,29,Sunday,93,12,14,13,132,high
08:15:00 AM,29,Sunday,125,22,12,12,171,heavy
08:30:00 AM,29,Sunday,109,26,16,9,160,heavy
08:45:00 AM,29,Sunday,99,25,15,12,151,heavy
09:00:00 AM,29,Sunday,78,6,29,14,127,high
09:15:00 AM,29,Sunday,63,6,21,9,99,low
09:30:00 AM,29,Sunday,36,11,25,8,80,low
09:45:00 AM,29,Sunday,69,5,23,16,113,high
10:00:00 AM,29,Sunday,67,13,15,17,112,high
10:15:00 AM,29,Sunday,34,12,28,11,85,low
10:30:00 AM,29,Sunday,71,6,12,19,108,high
10:45:00 AM,29,Sunday,22,9,0,31,62,low
11:00:00 AM,29,Sunday,54,4,10,35,103,high
11:15:00 AM,29,Sunday,27,8,13,35,83,low
11:30:00 AM,29,Sunday,36,2,7,27,72,low
11:45:00 AM,29,Sunday,29,9,13,28,79,low
12:00:00 PM,29,Sunday,65,3,12,25,105,high
12:15:00 PM,29,Sunday,66,5,7,35,113,high
12:30:00 PM,29,Sunday,23,4,5,30,62,low
12:45:00 PM,29,Sunday,42,10,2,25,79,low
01:00:00 PM,29,Sunday,55,5,33,20,113,high
01:15:00 PM,29,Sunday,18,5,15,21,59,low
01:30:00 PM,29,Sunday,22,13,17,22,74,low
01:45:00 PM,29,Sunday,59,18,18,23,118,high
02:00:00 PM,29,Sunday,63,16,3,13,95,low
02:15:00 PM,29,Sunday,66,3,25,12,106,high
02:30:00 PM,29,Sunday,75,4,3,15,97,low
02:45:00 PM,29,Sunday,92,7,35,25,159,heavy
03:00:00 PM,29,Sunday,40,14,16,28,98,low
03:15:00 PM,29,Sunday,39,2,8,19,68,low
03:30:00 PM,29,Sunday,43,11,16,20,90,low
03:45:00 PM,29,Sunday,128,26,25,12,191,heavy
04:00:00 PM,29,Sunday,150,24,30,12,216,heavy
04:15:00 PM,29,Sunday,108,6,37,18,169,heavy
04:30:00 PM,29,Sunday,111,17,40,18,186,heavy
04:45:00 PM,29,Sunday,112,24,39,16,191,heavy
05:00:00 PM,29,Sunday,140,10,38,18,206,heavy
05:15:00 PM,29,Sunday,144,13,15,14,186,heavy
05:30:00 PM,29,Sunday,127,17,24,17,185,heavy
05:45:00 PM,29,Sunday,100,8,13,11,132,high
06:00:00 PM,29,Sunday,138,9,16,20,183,heavy
06:15:00 PM,29,Sunday,108,10,21,16,155,heavy
06:30:00 PM,29,Sunday,82,8,19,12,121,high
06:45:00 PM,29,Sunday,107,19,6,17,149,high
07:00:00 PM,29,Sunday,73,1,10,32,116,high
07:15:00 PM,29,Sunday,54,4,13,34,105,high
07:30:00 PM,29,Sunday,68,10,20,13,111,high
07:45:00 PM,29,Sunday,70,9,13,25,117,high
08:00:00 PM,29,Sunday,58,20,17,16,111,high
08:15:00 PM,29,Sunday,99,12,13,16,140,high
08:30:00 PM,29,Sunday,100,14,16,28,158,heavy
08:45:00 PM,29,Sunday,68,14,16,20,118,heavy
09:00:00 PM,29,Sunday,106,11,17,27,161,heavy
09:15:00 PM,29,Sunday,83,13,9,34,139,high
09:30:00 PM,29,Sunday,66,14,8,24,112,high
09:45:00 PM,29,Sunday,6,1,2,29,38,normal
10:00:00 PM,29,Sunday,11,0,0,27,38,normal
10:15:00 PM,29,Sunday,11,2,1,29,43,normal
10:30:00 PM,29,Sunday,8,2,1,28,39,normal
10:45:00 PM,29,Sunday,13,2,1,23,39,normal
11:00:00 PM,29,Sunday,7,1,1,20,29,normal
11:15:00 PM,29,Sunday,7,2,1,35,45,normal
11:30:00 PM,29,Sunday,5,2,0,25,32,normal
11:45:00 PM,29,Sunday,10,2,0,40,52,low
12:00:00 AM,30,Monday,14,2,0,33,49,normal
12:15:00 AM,30,Monday,12,1,0,38,51,low
12:30:00 AM,30,Monday,7,1,0,27,35,normal
12:45:00 AM,30,Monday,15,0,1,28,44,normal
01:00:00 AM,30,Monday,12,2,1,31,46,normal
01:15:00 AM,30,Monday,15,0,2,21,38,normal
01:30:00 AM,30,Monday,12,1,0,36,49,normal
01:45:00 AM,30,Monday,9,1,1,26,37,normal
02:00:00 AM,30,Monday,7,2,1,39,49,normal
02:15:00 AM,30,Monday,13,2,0,40,55,low
02:30:00 AM,30,Monday,14,1,1,27,43,normal
02:45:00 AM,30,Monday,9,0,2,24,35,normal
03:00:00 AM,30,Monday,13,0,0,38,51,low
03:15:00 AM,30,Monday,15,2,0,32,49,normal
03:30:00 AM,30,Monday,6,0,2,24,32,normal
03:45:00 AM,30,Monday,7,0,2,31,40,normal
04:00:00 AM,30,Monday,84,8,2,12,106,high
04:15:00 AM,30,Monday,71,0,4,23,98,low
04:30:00 AM,30,Monday,80,8,4,21,113,high
04:45:00 AM,30,Monday,77,10,7,27,121,high
05:00:00 AM,30,Monday,86,9,1,29,125,high
05:15:00 AM,30,Monday,71,0,5,18,94,low
05:30:00 AM,30,Monday,78,6,2,11,97,low
05:45:00 AM,30,Monday,82,22,10,9,123,high
06:00:00 AM,30,Monday,114,14,16,13,157,heavy
06:15:00 AM,30,Monday,115,22,23,13,173,heavy
06:30:00 AM,30,Monday,81,18,12,11,122,high
06:45:00 AM,30,Monday,145,10,23,13,191,heavy
07:00:00 AM,30,Monday,84,21,14,13,132,high
07:15:00 AM,30,Monday,109,27,13,14,163,heavy
07:30:00 AM,30,Monday,103,23,10,9,145,high
07:45:00 AM,30,Monday,131,27,20,9,187,heavy
08:00:00 AM,30,Monday,113,29,12,15,169,heavy
08:15:00 AM,30,Monday,127,18,20,7,172,heavy
08:30:00 AM,30,Monday,125,24,17,8,174,heavy
08:45:00 AM,30,Monday,88,28,25,8,149,high
09:00:00 AM,30,Monday,54,8,10,15,87,low
09:15:00 AM,30,Monday,78,15,19,14,126,high
09:30:00 AM,30,Monday,39,11,16,16,82,low
09:45:00 AM,30,Monday,56,9,26,20,111,high
10:00:00 AM,30,Monday,32,10,19,18,79,low
10:15:00 AM,30,Monday,70,5,18,7,100,low
10:30:00 AM,30,Monday,55,10,30,15,110,high
10:45:00 AM,30,Monday,66,5,6,26,103,high
11:00:00 AM,30,Monday,26,6,1,30,63,low
11:15:00 AM,30,Monday,50,1,13,29,93,low
11:30:00 AM,30,Monday,52,7,1,26,86,low
11:45:00 AM,30,Monday,23,8,13,34,78,low
12:00:00 PM,30,Monday,59,9,11,28,107,high
12:15:00 PM,30,Monday,43,1,6,25,75,low
12:30:00 PM,30,Monday,21,8,4,32,65,low
12:45:00 PM,30,Monday,23,7,9,31,70,low
01:00:00 PM,30,Monday,51,3,7,17,78,low
01:15:00 PM,30,Monday,84,0,30,19,133,high
01:30:00 PM,30,Monday,17,19,3,10,49,normal
01:45:00 PM,30,Monday,79,9,19,11,118,high
02:00:00 PM,30,Monday,66,19,29,20,134,high
02:15:00 PM,30,Monday,6,12,29,25,72,low
02:30:00 PM,30,Monday,61,7,25,21,114,high
02:45:00 PM,30,Monday,68,12,5,11,96,low
03:00:00 PM,30,Monday,23,13,28,27,91,low
03:15:00 PM,30,Monday,22,18,15,21,76,low
03:30:00 PM,30,Monday,38,13,13,11,75,low
03:45:00 PM,30,Monday,146,14,11,17,188,heavy
04:00:00 PM,30,Monday,123,13,31,16,183,heavy
04:15:00 PM,30,Monday,132,27,33,19,211,heavy
04:30:00 PM,30,Monday,134,17,13,20,184,heavy
04:45:00 PM,30,Monday,138,7,40,11,196,heavy
05:00:00 PM,30,Monday,100,26,17,19,162,heavy
05:15:00 PM,30,Monday,117,12,36,15,180,heavy
05:30:00 PM,30,Monday,142,6,28,15,191,heavy
05:45:00 PM,30,Monday,149,24,36,12,221,heavy
06:00:00 PM,30,Monday,110,14,35,11,170,heavy
06:15:00 PM,30,Monday,105,5,20,13,143,high
06:30:00 PM,30,Monday,91,4,13,11,119,high
06:45:00 PM,30,Monday,106,4,6,15,131,high
07:00:00 PM,30,Monday,83,3,11,31,128,high
07:15:00 PM,30,Monday,57,0,10,29,96,low
07:30:00 PM,30,Monday,54,15,18,22,109,high
07:45:00 PM,30,Monday,66,9,18,32,125,high
08:00:00 PM,30,Monday,53,6,8,27,94,low
08:15:00 PM,30,Monday,108,18,16,30,172,heavy
08:30:00 PM,30,Monday,91,15,14,28,148,high
08:45:00 PM,30,Monday,107,17,5,20,149,high
09:00:00 PM,30,Monday,83,9,19,14,125,high
09:15:00 PM,30,Monday,88,6,6,15,115,high
09:30:00 PM,30,Monday,110,1,17,23,151,heavy
09:45:00 PM,30,Monday,7,2,2,27,38,normal
10:00:00 PM,30,Monday,10,2,1,22,35,normal
10:15:00 PM,30,Monday,11,1,1,24,37,normal
10:30:00 PM,30,Monday,6,1,0,25,32,normal
10:45:00 PM,30,Monday,11,1,2,21,35,normal
11:00:00 PM,30,Monday,12,1,0,36,49,normal
11:15:00 PM,30,Monday,9,1,0,31,41,normal
11:30:00 PM,30,Monday,15,0,0,38,53,low
11:45:00 PM,30,Monday,5,0,1,21,27,normal
12:00:00 AM,31,Tuesday,10,0,2,27,39,normal
12:15:00 AM,31,Tuesday,13,2,2,28,45,normal
12:30:00 AM,31,Tuesday,10,0,1,21,32,normal
12:45:00 AM,31,Tuesday,13,2,1,32,48,normal
01:00:00 AM,31,Tuesday,13,1,2,31,47,normal
01:15:00 AM,31,Tuesday,10,2,0,37,49,normal
01:30:00 AM,31,Tuesday,5,2,2,34,43,normal
01:45:00 AM,31,Tuesday,14,0,1,21,36,normal
02:00:00 AM,31,Tuesday,10,1,2,39,52,low
02:15:00 AM,31,Tuesday,9,0,2,40,51,low
02:30:00 AM,31,Tuesday,14,0,0,31,45,normal
02:45:00 AM,31,Tuesday,5,2,1,29,37,normal
03:00:00 AM,31,Tuesday,10,2,0,22,34,normal
03:15:00 AM,31,Tuesday,10,2,2,34,48,normal
03:30:00 AM,31,Tuesday,12,2,2,29,45,normal
03:45:00 AM,31,Tuesday,7,2,1,32,42,normal
04:00:00 AM,31,Tuesday,70,5,5,29,109,high
04:15:00 AM,31,Tuesday,67,5,6,19,97,low
04:30:00 AM,31,Tuesday,52,6,5,14,77,low
04:45:00 AM,31,Tuesday,59,0,4,27,90,low
05:00:00 AM,31,Tuesday,66,1,6,19,92,low
05:15:00 AM,31,Tuesday,62,6,3,18,89,low
05:30:00 AM,31,Tuesday,72,7,5,14,98,low
05:45:00 AM,31,Tuesday,90,10,14,9,123,high
06:00:00 AM,31,Tuesday,86,22,10,12,130,high
06:15:00 AM,31,Tuesday,125,25,22,5,177,heavy
06:30:00 AM,31,Tuesday,81,29,24,15,149,high
06:45:00 AM,31,Tuesday,150,15,22,12,199,heavy
07:00:00 AM,31,Tuesday,98,15,11,15,139,high
07:15:00 AM,31,Tuesday,119,24,21,9,173,heavy
07:30:00 AM,31,Tuesday,104,23,15,6,148,high
07:45:00 AM,31,Tuesday,81,15,20,11,127,high
08:00:00 AM,31,Tuesday,90,26,25,7,148,high
08:15:00 AM,31,Tuesday,93,26,19,6,144,high
08:30:00 AM,31,Tuesday,110,25,13,9,157,heavy
08:45:00 AM,31,Tuesday,125,16,15,10,166,heavy
09:00:00 AM,31,Tuesday,47,10,9,9,75,low
09:15:00 AM,31,Tuesday,61,14,18,14,107,high
09:30:00 AM,31,Tuesday,48,8,14,8,78,low
09:45:00 AM,31,Tuesday,42,12,6,17,77,low
10:00:00 AM,31,Tuesday,36,7,27,8,78,low
10:15:00 AM,31,Tuesday,30,10,28,5,73,low
10:30:00 AM,31,Tuesday,76,15,14,20,125,high
10:45:00 AM,31,Tuesday,44,7,6,30,87,low
11:00:00 AM,31,Tuesday,30,1,12,29,72,low
11:15:00 AM,31,Tuesday,56,7,7,34,104,high
11:30:00 AM,31,Tuesday,67,3,5,35,110,high
11:45:00 AM,31,Tuesday,55,8,2,30,95,low
12:00:00 PM,31,Tuesday,52,10,13,35,110,high
12:15:00 PM,31,Tuesday,28,4,0,35,67,low
12:30:00 PM,31,Tuesday,69,0,13,25,107,high
12:45:00 PM,31,Tuesday,42,9,5,25,81,low
01:00:00 PM,31,Tuesday,95,3,2,27,127,high
01:15:00 PM,31,Tuesday,45,13,33,27,118,high
01:30:00 PM,31,Tuesday,69,5,2,15,91,low
01:45:00 PM,31,Tuesday,85,19,2,28,134,high
02:00:00 PM,31,Tuesday,87,15,6,27,135,high
02:15:00 PM,31,Tuesday,100,13,7,17,137,high
02:30:00 PM,31,Tuesday,5,19,3,10,37,normal
02:45:00 PM,31,Tuesday,50,13,12,17,92,low
03:00:00 PM,31,Tuesday,64,3,17,11,95,low
03:15:00 PM,31,Tuesday,97,2,5,18,122,high
03:30:00 PM,31,Tuesday,97,8,30,27,162,heavy
03:45:00 PM,31,Tuesday,101,13,31,19,164,heavy
04:00:00 PM,31,Tuesday,139,29,34,10,212,heavy
04:15:00 PM,31,Tuesday,139,18,39,17,213,heavy
04:30:00 PM,31,Tuesday,105,12,39,14,170,heavy
04:45:00 PM,31,Tuesday,101,26,25,18,170,heavy
05:00:00 PM,31,Tuesday,109,25,36,11,181,heavy
05:15:00 PM,31,Tuesday,135,19,13,16,183,heavy
05:30:00 PM,31,Tuesday,118,18,14,19,169,heavy
05:45:00 PM,31,Tuesday,102,29,36,18,185,heavy
06:00:00 PM,31,Tuesday,136,25,31,18,210,heavy
06:15:00 PM,31,Tuesday,112,22,26,13,173,heavy
06:30:00 PM,31,Tuesday,105,17,16,16,154,heavy
06:45:00 PM,31,Tuesday,57,12,12,35,116,high
07:00:00 PM,31,Tuesday,52,19,14,34,119,high
07:15:00 PM,31,Tuesday,67,6,11,17,101,high
07:30:00 PM,31,Tuesday,64,6,12,32,114,high
07:45:00 PM,31,Tuesday,107,6,12,32,157,heavy
08:00:00 PM,31,Tuesday,87,7,5,11,110,high
08:15:00 PM,31,Tuesday,71,8,13,28,120,high
08:30:00 PM,31,Tuesday,91,6,7,35,139,high
08:45:00 PM,31,Tuesday,82,3,16,24,125,high
09:00:00 PM,31,Tuesday,98,16,8,31,153,high
09:15:00 PM,31,Tuesday,84,5,6,35,130,high
09:30:00 PM,31,Tuesday,98,18,8,18,142,high
09:45:00 PM,31,Tuesday,5,1,1,28,35,normal
10:00:00 PM,31,Tuesday,6,2,0,31,39,normal
10:15:00 PM,31,Tuesday,7,1,0,31,39,normal
10:30:00 PM,31,Tuesday,11,1,0,30,42,normal
10:45:00 PM,31,Tuesday,12,1,2,26,41,normal
11:00:00 PM,31,Tuesday,11,0,0,34,45,normal
11:15:00 PM,31,Tuesday,6,2,1,29,38,normal
11:30:00 PM,31,Tuesday,6,0,0,36,42,normal
11:45:00 PM,31,Tuesday,9,1,1,38,49,normal
12:00:00 AM,1,Wednesday,13,2,0,30,45,normal
12:15:00 AM,1,Wednesday,11,1,1,39,52,low
12:30:00 AM,1,Wednesday,15,0,1,34,50,normal
12:45:00 AM,1,Wednesday,13,1,0,37,51,low
01:00:00 AM,1,Wednesday,13,0,0,32,45,normal
01:15:00 AM,1,Wednesday,5,1,1,27,34,normal
01:30:00 AM,1,Wednesday,13,1,2,27,43,normal
01:45:00 AM,1,Wednesday,15,1,0,27,43,normal
02:00:00 AM,1,Wednesday,10,1,0,22,33,normal
02:15:00 AM,1,Wednesday,15,2,2,39,58,normal
02:30:00 AM,1,Wednesday,7,2,2,30,41,normal
02:45:00 AM,1,Wednesday,5,0,0,35,40,normal
03:00:00 AM,1,Wednesday,15,1,1,37,54,low
03:15:00 AM,1,Wednesday,5,0,1,22,28,normal
03:30:00 AM,1,Wednesday,7,2,1,23,33,normal
03:45:00 AM,1,Wednesday,15,1,0,28,44,normal
04:00:00 AM,1,Wednesday,88,1,3,17,109,high
04:15:00 AM,1,Wednesday,70,8,6,13,97,low
04:30:00 AM,1,Wednesday,71,4,5,23,103,high
04:45:00 AM,1,Wednesday,72,9,1,26,108,high
05:00:00 AM,1,Wednesday,59,2,0,12,73,low
05:15:00 AM,1,Wednesday,52,7,0,13,72,low
05:30:00 AM,1,Wednesday,54,7,2,30,93,low
05:45:00 AM,1,Wednesday,82,30,21,10,143,high
06:00:00 AM,1,Wednesday,124,27,25,15,191,heavy
06:15:00 AM,1,Wednesday,143,22,21,5,191,heavy
06:30:00 AM,1,Wednesday,107,21,15,11,154,heavy
06:45:00 AM,1,Wednesday,95,30,24,6,155,heavy
07:00:00 AM,1,Wednesday,106,29,23,11,169,heavy
07:15:00 AM,1,Wednesday,145,22,24,14,205,heavy
07:30:00 AM,1,Wednesday,111,17,15,12,155,heavy
07:45:00 AM,1,Wednesday,142,13,14,6,175,heavy
08:00:00 AM,1,Wednesday,112,22,17,15,166,heavy
08:15:00 AM,1,Wednesday,134,27,19,8,188,heavy
08:30:00 AM,1,Wednesday,86,15,23,6,130,high
08:45:00 AM,1,Wednesday,103,19,15,9,146,high
09:00:00 AM,1,Wednesday,55,11,25,14,105,high
09:15:00 AM,1,Wednesday,62,8,21,10,101,high
09:30:00 AM,1,Wednesday,41,8,5,17,71,low
09:45:00 AM,1,Wednesday,58,10,14,7,89,low
10:00:00 AM,1,Wednesday,78,14,13,7,112,high
10:15:00 AM,1,Wednesday,49,12,13,12,86,low
10:30:00 AM,1,Wednesday,63,10,10,20,103,high
10:45:00 AM,1,Wednesday,45,0,12,30,87,low
11:00:00 AM,1,Wednesday,69,7,6,27,109,high
11:15:00 AM,1,Wednesday,50,6,10,35,101,high
11:30:00 AM,1,Wednesday,66,6,12,25,109,high
11:45:00 AM,1,Wednesday,47,10,2,34,93,low
12:00:00 PM,1,Wednesday,61,2,9,27,99,low
12:15:00 PM,1,Wednesday,57,10,0,27,94,low
12:30:00 PM,1,Wednesday,26,3,3,29,61,low
12:45:00 PM,1,Wednesday,30,4,2,32,68,low
01:00:00 PM,1,Wednesday,9,13,2,19,43,normal
01:15:00 PM,1,Wednesday,46,10,34,21,111,high
01:30:00 PM,1,Wednesday,11,16,28,23,78,low
01:45:00 PM,1,Wednesday,96,1,5,25,127,high
02:00:00 PM,1,Wednesday,29,12,18,18,77,low
02:15:00 PM,1,Wednesday,50,8,34,26,118,high
02:30:00 PM,1,Wednesday,85,7,5,20,117,high
02:45:00 PM,1,Wednesday,77,12,22,23,134,high
03:00:00 PM,1,Wednesday,16,4,2,14,36,normal
03:15:00 PM,1,Wednesday,38,17,5,14,74,low
03:30:00 PM,1,Wednesday,11,10,23,17,61,low
03:45:00 PM,1,Wednesday,119,18,17,14,168,heavy
04:00:00 PM,1,Wednesday,111,8,37,10,166,heavy
04:15:00 PM,1,Wednesday,118,10,13,16,157,heavy
04:30:00 PM,1,Wednesday,119,13,28,13,173,heavy
04:45:00 PM,1,Wednesday,144,18,28,13,203,heavy
05:00:00 PM,1,Wednesday,133,29,14,11,187,heavy
05:15:00 PM,1,Wednesday,134,5,21,15,175,heavy
05:30:00 PM,1,Wednesday,140,20,27,13,200,heavy
05:45:00 PM,1,Wednesday,116,27,34,20,197,heavy
06:00:00 PM,1,Wednesday,121,15,19,20,175,heavy
06:15:00 PM,1,Wednesday,123,30,32,12,197,heavy
06:30:00 PM,1,Wednesday,62,0,19,34,115,high
06:45:00 PM,1,Wednesday,91,17,14,15,137,high
07:00:00 PM,1,Wednesday,107,20,20,19,166,heavy
07:15:00 PM,1,Wednesday,75,14,5,35,129,high
07:30:00 PM,1,Wednesday,96,3,10,33,142,high
07:45:00 PM,1,Wednesday,66,2,11,24,103,high
08:00:00 PM,1,Wednesday,89,15,13,31,148,high
08:15:00 PM,1,Wednesday,69,13,7,22,111,high
08:30:00 PM,1,Wednesday,109,16,19,13,157,heavy
08:45:00 PM,1,Wednesday,54,0,20,11,85,low
09:00:00 PM,1,Wednesday,79,0,8,25,112,high
09:15:00 PM,1,Wednesday,78,17,20,11,126,high
09:30:00 PM,1,Wednesday,93,0,10,18,121,high
09:45:00 PM,1,Wednesday,9,1,1,36,47,normal
10:00:00 PM,1,Wednesday,13,0,0,29,42,normal
10:15:00 PM,1,Wednesday,13,2,1,28,44,normal
10:30:00 PM,1,Wednesday,14,0,0,40,54,normal
10:45:00 PM,1,Wednesday,11,1,1,35,48,normal
11:00:00 PM,1,Wednesday,11,2,1,38,52,low
11:15:00 PM,1,Wednesday,15,1,2,35,53,low
11:30:00 PM,1,Wednesday,7,1,0,38,46,normal
11:45:00 PM,1,Wednesday,10,0,0,32,42,normal
12:00:00 AM,2,Thursday,6,2,1,35,44,normal
12:15:00 AM,2,Thursday,13,2,1,33,49,normal
12:30:00 AM,2,Thursday,8,0,0,39,47,normal
12:45:00 AM,2,Thursday,9,0,0,35,44,normal
01:00:00 AM,2,Thursday,6,2,2,35,45,normal
01:15:00 AM,2,Thursday,13,2,1,25,41,normal
01:30:00 AM,2,Thursday,12,0,0,33,45,normal
01:45:00 AM,2,Thursday,12,1,1,33,47,normal
02:00:00 AM,2,Thursday,11,2,0,20,33,normal
02:15:00 AM,2,Thursday,11,2,2,27,42,normal
02:30:00 AM,2,Thursday,9,1,0,26,36,normal
02:45:00 AM,2,Thursday,12,2,0,33,47,normal
03:00:00 AM,2,Thursday,11,0,1,40,52,low
03:15:00 AM,2,Thursday,8,2,2,23,35,normal
03:30:00 AM,2,Thursday,6,2,1,32,41,normal
03:45:00 AM,2,Thursday,8,1,2,31,42,normal
04:00:00 AM,2,Thursday,50,9,4,12,75,low
04:15:00 AM,2,Thursday,90,0,4,21,115,high
04:30:00 AM,2,Thursday,51,7,5,11,74,low
04:45:00 AM,2,Thursday,83,0,4,13,100,low
05:00:00 AM,2,Thursday,86,5,0,21,112,high
05:15:00 AM,2,Thursday,76,0,3,22,101,high
05:30:00 AM,2,Thursday,72,4,5,16,97,low
05:45:00 AM,2,Thursday,101,20,18,13,152,heavy
06:00:00 AM,2,Thursday,139,13,21,8,181,heavy
06:15:00 AM,2,Thursday,113,27,12,8,160,heavy
06:30:00 AM,2,Thursday,125,26,12,15,178,heavy
06:45:00 AM,2,Thursday,130,18,17,13,178,heavy
07:00:00 AM,2,Thursday,129,17,21,5,172,heavy
07:15:00 AM,2,Thursday,104,28,10,8,150,high
07:30:00 AM,2,Thursday,85,27,21,13,146,high
07:45:00 AM,2,Thursday,95,12,25,15,147,high
08:00:00 AM,2,Thursday,105,20,11,8,144,high
08:15:00 AM,2,Thursday,129,27,21,9,186,heavy
08:30:00 AM,2,Thursday,122,26,21,10,179,heavy
08:45:00 AM,2,Thursday,80,14,22,6,122,high
09:00:00 AM,2,Thursday,67,8,25,20,120,high
09:15:00 AM,2,Thursday,74,7,17,10,108,high
09:30:00 AM,2,Thursday,30,8,25,10,73,low
09:45:00 AM,2,Thursday,58,8,23,19,108,high
10:00:00 AM,2,Thursday,57,13,10,9,89,low
10:15:00 AM,2,Thursday,55,12,30,5,102,high
10:30:00 AM,2,Thursday,44,5,11,18,78,low
10:45:00 AM,2,Thursday,59,5,10,31,105,high
11:00:00 AM,2,Thursday,57,1,12,28,98,low
11:15:00 AM,2,Thursday,67,6,6,29,108,high
11:30:00 AM,2,Thursday,46,6,11,35,98,low
11:45:00 AM,2,Thursday,39,5,10,27,81,low
12:00:00 PM,2,Thursday,39,8,5,32,84,low
12:15:00 PM,2,Thursday,20,4,9,31,64,low
12:30:00 PM,2,Thursday,70,1,8,25,104,high
12:45:00 PM,2,Thursday,31,8,13,25,77,low
01:00:00 PM,2,Thursday,10,4,3,18,35,normal
01:15:00 PM,2,Thursday,55,7,24,15,101,high
01:30:00 PM,2,Thursday,72,12,18,23,125,high
01:45:00 PM,2,Thursday,38,7,27,13,85,low
02:00:00 PM,2,Thursday,79,12,22,14,127,high
02:15:00 PM,2,Thursday,40,9,6,10,65,low
02:30:00 PM,2,Thursday,28,2,1,11,42,normal
02:45:00 PM,2,Thursday,99,6,10,23,138,high
03:00:00 PM,2,Thursday,44,19,28,26,117,high
03:15:00 PM,2,Thursday,91,0,11,25,127,high
03:30:00 PM,2,Thursday,28,15,17,20,80,low
03:45:00 PM,2,Thursday,111,27,20,20,178,heavy
04:00:00 PM,2,Thursday,113,10,33,10,166,heavy
04:15:00 PM,2,Thursday,119,27,17,17,180,heavy
04:30:00 PM,2,Thursday,146,28,12,11,197,heavy
04:45:00 PM,2,Thursday,127,30,20,13,190,heavy
05:00:00 PM,2,Thursday,138,10,10,20,178,heavy
05:15:00 PM,2,Thursday,107,27,19,18,171,heavy
05:30:00 PM,2,Thursday,102,14,16,20,152,heavy
05:45:00 PM,2,Thursday,125,29,12,14,180,heavy
06:00:00 PM,2,Thursday,112,12,30,10,164,heavy
06:15:00 PM,2,Thursday,123,19,14,19,175,heavy
06:30:00 PM,2,Thursday,106,19,7,15,147,high
06:45:00 PM,2,Thursday,76,16,13,20,125,high
07:00:00 PM,2,Thursday,65,5,6,19,95,low
07:15:00 PM,2,Thursday,59,18,8,24,109,high
07:30:00 PM,2,Thursday,99,0,5,30,134,high
07:45:00 PM,2,Thursday,74,1,8,25,108,high
08:00:00 PM,2,Thursday,105,16,15,33,169,heavy
08:15:00 PM,2,Thursday,57,8,11,16,92,low
08:30:00 PM,2,Thursday,100,16,13,20,149,high
08:45:00 PM,2,Thursday,91,16,16,22,145,high
09:00:00 PM,2,Thursday,71,4,15,34,124,high
09:15:00 PM,2,Thursday,70,12,19,15,116,high
09:30:00 PM,2,Thursday,68,0,7,14,89,low
09:45:00 PM,2,Thursday,12,1,1,30,44,normal
10:00:00 PM,2,Thursday,14,1,1,35,51,low
10:15:00 PM,2,Thursday,8,0,1,25,34,normal
10:30:00 PM,2,Thursday,7,2,2,20,31,normal
10:45:00 PM,2,Thursday,8,0,1,30,39,normal
11:00:00 PM,2,Thursday,13,0,1,30,44,normal
11:15:00 PM,2,Thursday,15,1,2,30,48,normal
11:30:00 PM,2,Thursday,9,1,1,32,43,normal
11:45:00 PM,2,Thursday,5,1,0,36,42,normal
12:00:00 AM,3,Friday,13,1,0,37,51,low
12:15:00 AM,3,Friday,14,0,2,30,46,normal
12:30:00 AM,3,Friday,13,1,2,26,42,normal
12:45:00 AM,3,Friday,8,0,1,32,41,normal
01:00:00 AM,3,Friday,10,0,1,37,48,normal
01:15:00 AM,3,Friday,15,1,0,27,43,normal
01:30:00 AM,3,Friday,7,2,2,40,51,low
01:45:00 AM,3,Friday,12,0,0,32,44,normal
02:00:00 AM,3,Friday,14,1,1,21,37,normal
02:15:00 AM,3,Friday,5,1,2,30,38,normal
02:30:00 AM,3,Friday,8,1,0,24,33,normal
02:45:00 AM,3,Friday,15,0,0,27,42,normal
03:00:00 AM,3,Friday,14,1,1,26,42,normal
03:15:00 AM,3,Friday,12,1,2,36,51,low
03:30:00 AM,3,Friday,13,1,1,25,40,normal
03:45:00 AM,3,Friday,14,2,0,38,54,low
04:00:00 AM,3,Friday,43,8,0,28,79,low
04:15:00 AM,3,Friday,26,1,2,34,63,low
04:30:00 AM,3,Friday,49,1,5,32,87,low
04:45:00 AM,3,Friday,65,9,2,53,129,high
05:00:00 AM,3,Friday,46,4,2,59,111,high
05:15:00 AM,3,Friday,79,4,3,26,112,high
05:30:00 AM,3,Friday,32,9,4,58,103,high
05:45:00 AM,3,Friday,57,3,3,38,101,high
06:00:00 AM,3,Friday,73,4,0,39,116,high
06:15:00 AM,3,Friday,29,1,0,39,69,low
06:30:00 AM,3,Friday,79,10,1,28,118,high
06:45:00 AM,3,Friday,59,8,5,44,116,high
07:00:00 AM,3,Friday,71,1,4,44,120,high
07:15:00 AM,3,Friday,50,10,2,56,118,high
07:30:00 AM,3,Friday,62,7,2,35,106,high
07:45:00 AM,3,Friday,72,0,4,27,103,high
08:00:00 AM,3,Friday,54,10,5,34,103,high
08:15:00 AM,3,Friday,31,3,3,26,63,low
08:30:00 AM,3,Friday,72,6,4,36,118,high
08:45:00 AM,3,Friday,68,6,1,28,103,high
09:00:00 AM,3,Friday,116,34,5,7,162,heavy
09:15:00 AM,3,Friday,149,37,14,10,210,heavy
09:30:00 AM,3,Friday,143,48,19,5,215,heavy
09:45:00 AM,3,Friday,143,21,6,6,176,heavy
10:00:00 AM,3,Friday,100,26,14,6,146,high
10:15:00 AM,3,Friday,139,30,13,10,192,heavy
10:30:00 AM,3,Friday,103,23,6,7,139,high
10:45:00 AM,3,Friday,136,38,13,6,193,heavy
11:00:00 AM,3,Friday,101,42,13,6,162,heavy
11:15:00 AM,3,Friday,144,43,13,8,208,heavy
11:30:00 AM,3,Friday,101,34,12,7,154,heavy
11:45:00 AM,3,Friday,109,31,8,8,156,heavy
12:00:00 PM,3,Friday,125,22,18,8,173,heavy
12:15:00 PM,3,Friday,108,28,16,9,161,heavy
12:30:00 PM,3,Friday,147,35,19,8,209,heavy
12:45:00 PM,3,Friday,128,49,7,9,193,heavy
01:00:00 PM,3,Friday,130,43,15,6,194,heavy
01:15:00 PM,3,Friday,102,23,8,6,139,high
01:30:00 PM,3,Friday,113,38,17,10,178,heavy
01:45:00 PM,3,Friday,147,38,5,8,198,heavy
02:00:00 PM,3,Friday,109,30,7,9,155,heavy
02:15:00 PM,3,Friday,123,29,16,10,178,heavy
02:30:00 PM,3,Friday,121,41,14,5,181,heavy
02:45:00 PM,3,Friday,136,46,9,10,201,heavy
03:00:00 PM,3,Friday,58,14,14,15,101,high
03:15:00 PM,3,Friday,62,6,7,12,87,low
03:30:00 PM,3,Friday,62,7,9,7,85,low
03:45:00 PM,3,Friday,55,6,2,18,81,low
04:00:00 PM,3,Friday,87,15,15,16,133,high
04:15:00 PM,3,Friday,62,5,14,9,90,low
04:30:00 PM,3,Friday,82,5,5,5,97,low
04:45:00 PM,3,Friday,68,5,0,16,89,low
05:00:00 PM,3,Friday,66,11,9,5,91,low
05:15:00 PM,3,Friday,76,14,15,11,116,high
05:30:00 PM,3,Friday,89,8,4,15,116,high
05:45:00 PM,3,Friday,81,13,0,14,108,high
06:00:00 PM,3,Friday,56,5,9,17,87,low
06:15:00 PM,3,Friday,52,6,5,6,69,low
06:30:00 PM,3,Friday,80,6,14,13,113,high
06:45:00 PM,3,Friday,81,15,11,20,127,high
07:00:00 PM,3,Friday,37,2,4,31,74,low
07:15:00 PM,3,Friday,24,1,3,35,63,low
07:30:00 PM,3,Friday,26,2,4,35,67,low
07:45:00 PM,3,Friday,28,2,2,41,73,low
08:00:00 PM,3,Friday,49,1,5,34,89,low
08:15:00 PM,3,Friday,38,1,2,40,81,low
08:30:00 PM,3,Friday,20,3,4,40,67,low
08:45:00 PM,3,Friday,28,0,3,42,73,low
09:00:00 PM,3,Friday,27,5,1,25,58,low
09:15:00 PM,3,Friday,28,2,4,44,78,low
09:30:00 PM,3,Friday,21,4,5,31,61,low
09:45:00 PM,3,Friday,5,1,2,33,41,normal
10:00:00 PM,3,Friday,7,1,0,22,30,normal
10:15:00 PM,3,Friday,13,0,2,29,44,normal
10:30:00 PM,3,Friday,15,0,1,28,44,normal
10:45:00 PM,3,Friday,15,0,1,38,54,low
11:00:00 PM,3,Friday,15,0,0,34,49,normal
11:15:00 PM,3,Friday,13,0,1,34,48,normal
11:30:00 PM,3,Friday,11,2,1,29,43,normal
11:45:00 PM,3,Friday,13,1,2,26,42,normal
12:00:00 AM,4,Saturday,15,0,1,21,37,normal
12:15:00 AM,4,Saturday,6,0,2,21,29,normal
12:30:00 AM,4,Saturday,12,0,2,37,51,low
12:45:00 AM,4,Saturday,6,0,2,23,31,normal
01:00:00 AM,4,Saturday,12,2,0,34,48,normal
01:15:00 AM,4,Saturday,8,0,1,35,44,normal
01:30:00 AM,4,Saturday,6,2,0,24,32,normal
01:45:00 AM,4,Saturday,14,1,1,35,51,low
02:00:00 AM,4,Saturday,14,0,1,27,42,normal
02:15:00 AM,4,Saturday,14,1,1,37,53,low
02:30:00 AM,4,Saturday,11,2,2,33,48,normal
02:45:00 AM,4,Saturday,8,0,1,20,29,normal
03:00:00 AM,4,Saturday,9,1,2,27,39,normal
03:15:00 AM,4,Saturday,8,1,1,27,37,normal
03:30:00 AM,4,Saturday,6,2,1,30,39,normal
03:45:00 AM,4,Saturday,7,2,2,27,38,normal
04:00:00 AM,4,Saturday,50,5,4,16,75,low
04:15:00 AM,4,Saturday,59,8,7,17,91,low
04:30:00 AM,4,Saturday,70,8,0,24,102,high
04:45:00 AM,4,Saturday,61,6,5,12,84,low
05:00:00 AM,4,Saturday,67,4,3,16,90,low
05:15:00 AM,4,Saturday,63,7,0,23,93,normal
05:30:00 AM,4,Saturday,53,1,1,23,78,normal
05:45:00 AM,4,Saturday,106,22,17,8,153,heavy
06:00:00 AM,4,Saturday,114,18,24,6,162,heavy
06:15:00 AM,4,Saturday,103,14,14,10,141,high
06:30:00 AM,4,Saturday,118,27,10,12,167,heavy
06:45:00 AM,4,Saturday,120,11,12,9,152,heavy
07:00:00 AM,4,Saturday,144,22,12,10,188,heavy
07:15:00 AM,4,Saturday,123,20,21,6,170,heavy
07:30:00 AM,4,Saturday,91,26,11,15,143,high
07:45:00 AM,4,Saturday,143,26,22,10,201,heavy
08:00:00 AM,4,Saturday,120,13,11,5,149,high
08:15:00 AM,4,Saturday,80,13,11,5,109,high
08:30:00 AM,4,Saturday,123,30,13,12,178,heavy
08:45:00 AM,4,Saturday,143,25,14,12,194,heavy
09:00:00 AM,4,Saturday,39,5,17,14,75,low
09:15:00 AM,4,Saturday,73,12,25,16,126,high
09:30:00 AM,4,Saturday,75,14,24,18,131,high
09:45:00 AM,4,Saturday,38,15,6,6,65,low
10:00:00 AM,4,Saturday,66,6,7,16,95,low
10:15:00 AM,4,Saturday,45,14,18,14,91,low
10:30:00 AM,4,Saturday,77,11,13,6,107,high
10:45:00 AM,4,Saturday,58,7,2,25,92,low
11:00:00 AM,4,Saturday,61,8,7,34,110,high
11:15:00 AM,4,Saturday,46,2,0,25,73,low
11:30:00 AM,4,Saturday,55,3,4,25,87,low
11:45:00 AM,4,Saturday,36,8,3,29,76,low
12:00:00 PM,4,Saturday,52,1,8,29,90,low
12:15:00 PM,4,Saturday,32,5,4,26,67,low
12:30:00 PM,4,Saturday,38,5,7,27,77,low
12:45:00 PM,4,Saturday,24,2,12,32,70,low
01:00:00 PM,4,Saturday,90,15,24,29,158,heavy
01:15:00 PM,4,Saturday,17,4,4,11,36,normal
01:30:00 PM,4,Saturday,85,5,1,26,117,high
01:45:00 PM,4,Saturday,34,17,19,20,90,low
02:00:00 PM,4,Saturday,55,16,17,16,104,high
02:15:00 PM,4,Saturday,25,3,28,17,73,low
02:30:00 PM,4,Saturday,64,13,9,12,98,low
02:45:00 PM,4,Saturday,59,14,24,21,118,high
03:00:00 PM,4,Saturday,11,3,2,14,30,normal
03:15:00 PM,4,Saturday,88,3,31,23,145,high
03:30:00 PM,4,Saturday,100,19,23,22,164,heavy
03:45:00 PM,4,Saturday,144,16,25,18,203,heavy
04:00:00 PM,4,Saturday,116,23,37,11,187,heavy
04:15:00 PM,4,Saturday,114,6,38,11,169,heavy
04:30:00 PM,4,Saturday,130,10,19,10,169,heavy
04:45:00 PM,4,Saturday,144,19,18,15,196,heavy
05:00:00 PM,4,Saturday,119,13,38,18,188,heavy
05:15:00 PM,4,Saturday,131,6,17,12,166,normal
05:30:00 PM,4,Saturday,123,18,18,12,171,heavy
05:45:00 PM,4,Saturday,147,14,32,10,203,heavy
06:00:00 PM,4,Saturday,114,27,32,10,183,heavy
06:15:00 PM,4,Saturday,113,27,35,10,185,heavy
06:30:00 PM,4,Saturday,98,8,9,14,129,high
06:45:00 PM,4,Saturday,76,3,8,13,100,low
07:00:00 PM,4,Saturday,108,8,6,21,143,high
07:15:00 PM,4,Saturday,63,11,5,26,105,high
07:30:00 PM,4,Saturday,72,20,5,18,115,high
07:45:00 PM,4,Saturday,80,0,12,13,105,high
08:00:00 PM,4,Saturday,59,7,14,16,96,low
08:15:00 PM,4,Saturday,99,12,14,34,159,heavy
08:30:00 PM,4,Saturday,65,16,9,14,104,high
08:45:00 PM,4,Saturday,81,18,16,33,148,high
09:00:00 PM,4,Saturday,103,14,11,11,139,high
09:15:00 PM,4,Saturday,81,18,5,17,121,high
09:30:00 PM,4,Saturday,52,9,5,34,100,low
09:45:00 PM,4,Saturday,6,0,2,40,48,normal
10:00:00 PM,4,Saturday,6,2,0,40,48,normal
10:15:00 PM,4,Saturday,9,1,0,22,32,normal
10:30:00 PM,4,Saturday,11,1,0,26,38,normal
10:45:00 PM,4,Saturday,14,2,1,39,56,low
11:00:00 PM,4,Saturday,7,1,1,30,39,normal
11:15:00 PM,4,Saturday,8,2,2,35,47,normal
11:30:00 PM,4,Saturday,5,2,2,33,42,normal
11:45:00 PM,4,Saturday,6,1,2,23,32,normal
12:00:00 AM,5,Sunday,15,0,2,32,49,normal
12:15:00 AM,5,Sunday,15,0,2,29,46,normal
12:30:00 AM,5,Sunday,7,2,2,33,44,normal
12:45:00 AM,5,Sunday,14,2,0,33,49,normal
01:00:00 AM,5,Sunday,6,1,1,38,46,normal
01:15:00 AM,5,Sunday,11,0,0,26,37,normal
01:30:00 AM,5,Sunday,6,2,1,34,43,normal
01:45:00 AM,5,Sunday,7,0,2,22,31,normal
02:00:00 AM,5,Sunday,13,2,0,24,39,normal
02:15:00 AM,5,Sunday,5,2,1,33,41,normal
02:30:00 AM,5,Sunday,10,0,1,40,51,low
02:45:00 AM,5,Sunday,12,1,2,26,41,normal
03:00:00 AM,5,Sunday,8,0,0,28,36,normal
03:15:00 AM,5,Sunday,7,0,2,36,45,normal
03:30:00 AM,5,Sunday,14,0,0,32,46,normal
03:45:00 AM,5,Sunday,14,2,2,39,57,low
04:00:00 AM,5,Sunday,57,6,1,30,94,low
04:15:00 AM,5,Sunday,64,4,7,15,90,low
04:30:00 AM,5,Sunday,80,9,7,29,125,high
04:45:00 AM,5,Sunday,80,2,2,18,102,high
05:00:00 AM,5,Sunday,78,4,0,11,93,low
05:15:00 AM,5,Sunday,51,8,0,29,88,low
05:30:00 AM,5,Sunday,66,3,0,27,96,low
05:45:00 AM,5,Sunday,146,19,25,8,198,heavy
06:00:00 AM,5,Sunday,104,22,15,8,149,high
06:15:00 AM,5,Sunday,137,22,14,10,183,heavy
06:30:00 AM,5,Sunday,150,26,18,10,204,heavy
06:45:00 AM,5,Sunday,148,15,22,8,193,heavy
07:00:00 AM,5,Sunday,83,30,12,10,135,high
07:15:00 AM,5,Sunday,96,22,23,8,149,high
07:30:00 AM,5,Sunday,112,10,23,11,156,heavy
07:45:00 AM,5,Sunday,145,20,24,13,202,heavy
08:00:00 AM,5,Sunday,86,28,19,9,142,high
08:15:00 AM,5,Sunday,127,27,17,15,186,heavy
08:30:00 AM,5,Sunday,88,12,19,10,129,high
08:45:00 AM,5,Sunday,103,11,19,5,138,high
09:00:00 AM,5,Sunday,74,14,28,15,131,high
09:15:00 AM,5,Sunday,42,10,20,5,77,low
09:30:00 AM,5,Sunday,55,11,20,19,105,high
09:45:00 AM,5,Sunday,71,8,28,11,118,high
10:00:00 AM,5,Sunday,55,5,23,16,99,low
10:15:00 AM,5,Sunday,43,8,22,20,93,low
10:30:00 AM,5,Sunday,54,11,11,11,87,low
10:45:00 AM,5,Sunday,58,9,3,32,102,high
11:00:00 AM,5,Sunday,46,1,11,35,93,low
11:15:00 AM,5,Sunday,64,6,7,30,107,high
11:30:00 AM,5,Sunday,43,5,3,31,82,low
11:45:00 AM,5,Sunday,39,10,2,33,84,low
12:00:00 PM,5,Sunday,59,2,9,33,103,high
12:15:00 PM,5,Sunday,56,5,6,33,100,low
12:30:00 PM,5,Sunday,40,5,12,26,83,low
12:45:00 PM,5,Sunday,69,4,7,26,106,high
01:00:00 PM,5,Sunday,53,2,14,12,81,low
01:15:00 PM,5,Sunday,22,7,8,27,64,low
01:30:00 PM,5,Sunday,33,16,5,30,84,low
01:45:00 PM,5,Sunday,35,14,16,20,85,low
02:00:00 PM,5,Sunday,12,3,11,15,41,normal
02:15:00 PM,5,Sunday,83,12,8,23,126,high
02:30:00 PM,5,Sunday,39,7,11,19,76,low
02:45:00 PM,5,Sunday,44,12,25,12,93,low
03:00:00 PM,5,Sunday,57,19,11,16,103,high
03:15:00 PM,5,Sunday,13,19,7,12,51,low
03:30:00 PM,5,Sunday,79,17,12,13,121,high
03:45:00 PM,5,Sunday,127,20,16,17,180,heavy
04:00:00 PM,5,Sunday,112,19,15,18,164,heavy
04:15:00 PM,5,Sunday,122,12,20,19,173,heavy
04:30:00 PM,5,Sunday,141,22,29,12,204,heavy
04:45:00 PM,5,Sunday,131,29,33,12,205,heavy
05:00:00 PM,5,Sunday,126,6,22,15,169,heavy
05:15:00 PM,5,Sunday,128,14,11,18,171,heavy
05:30:00 PM,5,Sunday,137,29,36,18,220,heavy
05:45:00 PM,5,Sunday,129,18,10,18,175,heavy
06:00:00 PM,5,Sunday,100,30,31,20,181,heavy
06:15:00 PM,5,Sunday,136,16,17,11,180,heavy
06:30:00 PM,5,Sunday,94,8,14,19,135,high
06:45:00 PM,5,Sunday,86,14,13,33,146,high
07:00:00 PM,5,Sunday,81,0,7,15,103,high
07:15:00 PM,5,Sunday,84,1,16,19,120,high
07:30:00 PM,5,Sunday,76,11,16,17,120,high
07:45:00 PM,5,Sunday,76,11,19,17,123,high
08:00:00 PM,5,Sunday,83,10,19,18,130,high
08:15:00 PM,5,Sunday,60,2,10,18,90,low
08:30:00 PM,5,Sunday,55,9,15,25,104,high
08:45:00 PM,5,Sunday,69,3,19,32,123,high
09:00:00 PM,5,Sunday,52,2,9,19,82,low
09:15:00 PM,5,Sunday,74,9,15,33,131,high
09:30:00 PM,5,Sunday,102,18,20,31,171,heavy
09:45:00 PM,5,Sunday,9,2,2,31,44,normal
10:00:00 PM,5,Sunday,14,1,1,28,44,normal
10:15:00 PM,5,Sunday,8,2,2,35,47,normal
10:30:00 PM,5,Sunday,14,0,0,28,42,normal
10:45:00 PM,5,Sunday,6,2,2,40,50,normal
11:00:00 PM,5,Sunday,12,2,1,34,49,normal
11:15:00 PM,5,Sunday,15,0,1,25,41,normal
11:30:00 PM,5,Sunday,13,1,2,40,56,low
11:45:00 PM,5,Sunday,9,2,2,32,45,normal
12:00:00 AM,6,Monday,9,2,0,27,38,normal
12:15:00 AM,6,Monday,14,1,0,30,45,normal
12:30:00 AM,6,Monday,15,2,0,30,47,normal
12:45:00 AM,6,Monday,7,2,0,26,35,normal
01:00:00 AM,6,Monday,5,0,2,23,30,normal
01:15:00 AM,6,Monday,9,1,0,27,37,normal
01:30:00 AM,6,Monday,6,2,2,28,38,normal
01:45:00 AM,6,Monday,7,2,1,39,49,normal
02:00:00 AM,6,Monday,6,2,1,27,36,normal
02:15:00 AM,6,Monday,6,1,1,36,44,normal
02:30:00 AM,6,Monday,10,1,2,25,38,normal
02:45:00 AM,6,Monday,12,2,0,40,54,low
03:00:00 AM,6,Monday,10,0,1,34,45,normal
03:15:00 AM,6,Monday,8,0,1,22,31,normal
03:30:00 AM,6,Monday,10,0,2,37,49,normal
03:45:00 AM,6,Monday,12,1,2,21,36,normal
04:00:00 AM,6,Monday,73,7,2,22,104,high
04:15:00 AM,6,Monday,59,9,4,20,92,low
04:30:00 AM,6,Monday,52,2,5,30,89,low
04:45:00 AM,6,Monday,63,6,3,28,100,low
05:00:00 AM,6,Monday,77,2,5,19,103,high
05:15:00 AM,6,Monday,58,8,7,13,86,low
05:30:00 AM,6,Monday,72,1,5,11,89,low
05:45:00 AM,6,Monday,126,14,14,8,162,heavy
06:00:00 AM,6,Monday,91,29,19,15,154,heavy
06:15:00 AM,6,Monday,134,18,14,6,172,heavy
06:30:00 AM,6,Monday,96,18,16,7,137,high
06:45:00 AM,6,Monday,112,22,12,5,151,heavy
07:00:00 AM,6,Monday,125,22,10,9,166,heavy
07:15:00 AM,6,Monday,142,25,22,5,194,heavy
07:30:00 AM,6,Monday,102,19,13,10,144,high
07:45:00 AM,6,Monday,89,23,19,12,143,high
08:00:00 AM,6,Monday,119,15,17,12,163,heavy
08:15:00 AM,6,Monday,137,13,19,14,183,heavy
08:30:00 AM,6,Monday,128,21,19,13,181,heavy
08:45:00 AM,6,Monday,81,20,18,15,134,high
09:00:00 AM,6,Monday,49,15,15,5,84,low
09:15:00 AM,6,Monday,59,6,10,17,92,low
09:30:00 AM,6,Monday,69,5,26,6,106,high
09:45:00 AM,6,Monday,72,10,7,20,109,high
10:00:00 AM,6,Monday,44,15,16,16,91,low
10:15:00 AM,6,Monday,68,15,26,11,120,high
10:30:00 AM,6,Monday,74,9,14,6,103,high
10:45:00 AM,6,Monday,35,6,10,35,86,low
11:00:00 AM,6,Monday,62,9,12,32,115,high
11:15:00 AM,6,Monday,46,10,0,34,90,low
11:30:00 AM,6,Monday,63,5,2,31,101,high
11:45:00 AM,6,Monday,58,10,2,27,97,low
12:00:00 PM,6,Monday,68,0,12,35,115,high
12:15:00 PM,6,Monday,27,7,0,33,67,low
12:30:00 PM,6,Monday,24,4,11,33,72,low
12:45:00 PM,6,Monday,70,6,8,35,119,high
01:00:00 PM,6,Monday,14,19,22,15,70,low
01:15:00 PM,6,Monday,72,8,17,28,125,high
01:30:00 PM,6,Monday,14,0,26,20,60,low
01:45:00 PM,6,Monday,97,4,25,18,144,high
02:00:00 PM,6,Monday,23,19,3,19,64,low
02:15:00 PM,6,Monday,46,3,32,27,108,high
02:30:00 PM,6,Monday,23,17,27,13,80,low
02:45:00 PM,6,Monday,48,4,8,17,77,low
03:00:00 PM,6,Monday,89,13,7,27,136,high
03:15:00 PM,6,Monday,48,10,23,26,107,high
03:30:00 PM,6,Monday,77,13,19,11,120,high
03:45:00 PM,6,Monday,118,8,27,16,169,heavy
04:00:00 PM,6,Monday,145,19,22,19,205,heavy
04:15:00 PM,6,Monday,103,23,18,19,163,heavy
04:30:00 PM,6,Monday,126,22,28,16,192,heavy
04:45:00 PM,6,Monday,120,24,30,10,184,heavy
05:00:00 PM,6,Monday,128,10,14,18,170,heavy
05:15:00 PM,6,Monday,142,26,32,10,210,heavy
05:30:00 PM,6,Monday,121,25,33,13,192,heavy
05:45:00 PM,6,Monday,144,6,18,12,180,heavy
06:00:00 PM,6,Monday,116,26,14,18,174,heavy
06:15:00 PM,6,Monday,138,21,39,17,215,heavy
06:30:00 PM,6,Monday,103,5,7,13,128,high
06:45:00 PM,6,Monday,100,14,10,22,146,high
07:00:00 PM,6,Monday,93,11,20,11,135,high
07:15:00 PM,6,Monday,97,17,19,33,166,heavy
07:30:00 PM,6,Monday,81,9,15,25,130,high
07:45:00 PM,6,Monday,101,8,7,10,126,high
08:00:00 PM,6,Monday,106,7,7,26,146,high
08:15:00 PM,6,Monday,86,8,18,13,125,high
08:30:00 PM,6,Monday,74,14,12,20,120,high
08:45:00 PM,6,Monday,64,13,13,16,106,high
09:00:00 PM,6,Monday,60,20,12,32,124,high
09:15:00 PM,6,Monday,58,15,12,31,116,high
09:30:00 PM,6,Monday,95,7,18,34,154,high
09:45:00 PM,6,Monday,5,2,2,29,38,normal
10:00:00 PM,6,Monday,13,2,0,38,53,low
10:15:00 PM,6,Monday,8,1,1,33,43,normal
10:30:00 PM,6,Monday,5,2,0,31,38,normal
10:45:00 PM,6,Monday,5,1,1,25,32,normal
11:00:00 PM,6,Monday,15,2,2,32,51,low
11:15:00 PM,6,Monday,13,1,2,38,54,low
11:30:00 PM,6,Monday,6,2,1,22,31,normal
11:45:00 PM,6,Monday,8,1,2,27,38,normal
12:00:00 AM,7,Tuesday,9,0,0,39,48,normal
12:15:00 AM,7,Tuesday,15,1,1,31,48,normal
12:30:00 AM,7,Tuesday,8,0,2,25,35,normal
12:45:00 AM,7,Tuesday,15,1,0,29,45,normal
01:00:00 AM,7,Tuesday,6,1,1,34,42,normal
01:15:00 AM,7,Tuesday,10,2,1,33,46,normal
01:30:00 AM,7,Tuesday,9,0,1,23,33,normal
01:45:00 AM,7,Tuesday,10,1,0,28,39,normal
02:00:00 AM,7,Tuesday,10,2,1,38,51,low
02:15:00 AM,7,Tuesday,9,0,1,38,48,normal
02:30:00 AM,7,Tuesday,6,2,2,20,30,normal
02:45:00 AM,7,Tuesday,15,0,0,32,47,normal
03:00:00 AM,7,Tuesday,9,0,0,22,31,normal
03:15:00 AM,7,Tuesday,11,1,0,26,38,normal
03:30:00 AM,7,Tuesday,9,0,0,25,34,normal
03:45:00 AM,7,Tuesday,14,1,2,20,37,normal
04:00:00 AM,7,Tuesday,64,0,2,12,78,low
04:15:00 AM,7,Tuesday,60,8,7,11,86,low
04:30:00 AM,7,Tuesday,77,5,0,20,102,high
04:45:00 AM,7,Tuesday,59,1,7,11,78,low
05:00:00 AM,7,Tuesday,72,2,6,11,91,low
05:15:00 AM,7,Tuesday,86,10,2,12,110,high
05:30:00 AM,7,Tuesday,79,7,4,10,100,low
05:45:00 AM,7,Tuesday,128,29,24,9,190,heavy
06:00:00 AM,7,Tuesday,140,15,13,7,175,heavy
06:15:00 AM,7,Tuesday,150,28,12,9,199,heavy
06:30:00 AM,7,Tuesday,81,19,22,5,127,high
06:45:00 AM,7,Tuesday,88,12,12,6,118,high
07:00:00 AM,7,Tuesday,97,10,16,10,133,high
07:15:00 AM,7,Tuesday,92,11,23,11,137,high
07:30:00 AM,7,Tuesday,109,23,18,13,163,heavy
07:45:00 AM,7,Tuesday,104,29,21,15,169,heavy
08:00:00 AM,7,Tuesday,130,17,17,12,176,heavy
08:15:00 AM,7,Tuesday,90,18,25,6,139,high
08:30:00 AM,7,Tuesday,113,12,12,9,146,high
08:45:00 AM,7,Tuesday,98,29,24,5,156,heavy
09:00:00 AM,7,Tuesday,35,10,11,17,73,low
09:15:00 AM,7,Tuesday,31,13,11,7,62,low
09:30:00 AM,7,Tuesday,80,9,9,9,107,high
09:45:00 AM,7,Tuesday,60,10,8,11,89,low
10:00:00 AM,7,Tuesday,67,7,19,12,105,high
10:15:00 AM,7,Tuesday,38,15,9,19,81,low
10:30:00 AM,7,Tuesday,62,11,9,12,94,low
10:45:00 AM,7,Tuesday,21,10,0,25,56,low
11:00:00 AM,7,Tuesday,41,0,9,25,75,low
11:15:00 AM,7,Tuesday,57,1,6,29,93,low
11:30:00 AM,7,Tuesday,26,0,11,33,70,low
11:45:00 AM,7,Tuesday,50,9,10,29,98,low
12:00:00 PM,7,Tuesday,56,3,11,28,98,low
12:15:00 PM,7,Tuesday,59,4,8,30,101,high
12:30:00 PM,7,Tuesday,61,9,10,26,106,high
12:45:00 PM,7,Tuesday,56,7,8,31,102,high
01:00:00 PM,7,Tuesday,23,2,5,22,52,low
01:15:00 PM,7,Tuesday,73,8,10,23,114,high
01:30:00 PM,7,Tuesday,98,8,26,18,150,high
01:45:00 PM,7,Tuesday,22,6,23,10,61,low
02:00:00 PM,7,Tuesday,38,7,27,22,94,low
02:15:00 PM,7,Tuesday,76,12,8,15,111,high
02:30:00 PM,7,Tuesday,79,15,26,30,150,high
02:45:00 PM,7,Tuesday,76,6,6,29,117,high
03:00:00 PM,7,Tuesday,62,6,29,23,120,high
03:15:00 PM,7,Tuesday,19,2,23,25,69,low
03:30:00 PM,7,Tuesday,13,10,35,19,77,low
03:45:00 PM,7,Tuesday,105,6,16,18,145,high
04:00:00 PM,7,Tuesday,144,14,12,16,186,heavy
04:15:00 PM,7,Tuesday,121,17,35,14,187,heavy
04:30:00 PM,7,Tuesday,145,5,20,12,182,heavy
04:45:00 PM,7,Tuesday,127,11,24,16,178,heavy
05:00:00 PM,7,Tuesday,116,11,11,16,154,heavy
05:15:00 PM,7,Tuesday,128,9,29,20,186,heavy
05:30:00 PM,7,Tuesday,116,18,32,18,184,heavy
05:45:00 PM,7,Tuesday,149,20,17,13,199,heavy
06:00:00 PM,7,Tuesday,144,27,22,16,209,heavy
06:15:00 PM,7,Tuesday,145,6,40,13,204,heavy
06:30:00 PM,7,Tuesday,63,2,11,32,108,high
06:45:00 PM,7,Tuesday,110,16,18,34,178,heavy
07:00:00 PM,7,Tuesday,63,11,10,23,107,high
07:15:00 PM,7,Tuesday,106,8,10,31,155,heavy
07:30:00 PM,7,Tuesday,50,9,11,22,92,low
07:45:00 PM,7,Tuesday,53,13,12,15,93,low
08:00:00 PM,7,Tuesday,81,0,18,12,111,high
08:15:00 PM,7,Tuesday,90,20,20,10,140,high
08:30:00 PM,7,Tuesday,56,12,9,22,99,low
08:45:00 PM,7,Tuesday,90,0,11,32,133,high
09:00:00 PM,7,Tuesday,102,4,8,28,142,high
09:15:00 PM,7,Tuesday,99,0,11,21,131,high
09:30:00 PM,7,Tuesday,85,2,16,25,128,high
09:45:00 PM,7,Tuesday,13,2,2,26,43,normal
10:00:00 PM,7,Tuesday,12,1,1,20,34,normal
10:15:00 PM,7,Tuesday,7,0,1,35,43,normal
10:30:00 PM,7,Tuesday,9,0,2,38,49,normal
10:45:00 PM,7,Tuesday,8,1,0,26,35,normal
11:00:00 PM,7,Tuesday,5,0,0,35,40,normal
11:15:00 PM,7,Tuesday,13,1,2,30,46,normal
11:30:00 PM,7,Tuesday,7,2,2,37,48,normal
11:45:00 PM,7,Tuesday,9,2,2,28,41,normal
12:00:00 AM,8,Wednesday,6,1,1,35,43,normal
12:15:00 AM,8,Wednesday,14,0,1,20,35,normal
12:30:00 AM,8,Wednesday,11,0,2,39,52,low
12:45:00 AM,8,Wednesday,9,2,0,28,39,normal
01:00:00 AM,8,Wednesday,5,0,0,22,27,normal
01:15:00 AM,8,Wednesday,9,0,0,24,33,normal
01:30:00 AM,8,Wednesday,5,2,2,30,39,normal
01:45:00 AM,8,Wednesday,9,0,1,27,37,normal
02:00:00 AM,8,Wednesday,9,1,0,39,49,normal
02:15:00 AM,8,Wednesday,6,0,0,33,39,normal
02:30:00 AM,8,Wednesday,13,2,1,30,46,normal
02:45:00 AM,8,Wednesday,5,0,1,34,40,normal
03:00:00 AM,8,Wednesday,5,0,0,34,39,normal
03:15:00 AM,8,Wednesday,9,2,2,29,42,normal
03:30:00 AM,8,Wednesday,9,1,0,34,44,normal
03:45:00 AM,8,Wednesday,8,0,0,40,48,normal
04:00:00 AM,8,Wednesday,64,10,7,15,96,low
04:15:00 AM,8,Wednesday,66,3,1,26,96,low
04:30:00 AM,8,Wednesday,57,10,2,18,87,low
04:45:00 AM,8,Wednesday,76,7,4,15,102,high
05:00:00 AM,8,Wednesday,71,8,5,21,105,high
05:15:00 AM,8,Wednesday,65,0,6,30,101,high
05:30:00 AM,8,Wednesday,54,2,3,13,72,low
05:45:00 AM,8,Wednesday,107,10,23,5,145,high
06:00:00 AM,8,Wednesday,102,28,22,11,163,heavy
06:15:00 AM,8,Wednesday,118,16,19,8,161,heavy
06:30:00 AM,8,Wednesday,144,13,10,5,172,heavy
06:45:00 AM,8,Wednesday,147,21,12,11,191,heavy
07:00:00 AM,8,Wednesday,116,10,11,13,150,high
07:15:00 AM,8,Wednesday,142,11,25,5,183,heavy
07:30:00 AM,8,Wednesday,105,25,13,9,152,heavy
07:45:00 AM,8,Wednesday,138,23,17,12,190,heavy
08:00:00 AM,8,Wednesday,144,15,15,14,188,heavy
08:15:00 AM,8,Wednesday,122,24,17,9,172,heavy
08:30:00 AM,8,Wednesday,137,28,17,14,196,heavy
08:45:00 AM,8,Wednesday,113,16,12,12,153,heavy
09:00:00 AM,8,Wednesday,78,8,11,9,106,high
09:15:00 AM,8,Wednesday,44,12,27,13,96,low
09:30:00 AM,8,Wednesday,57,13,11,14,95,low
09:45:00 AM,8,Wednesday,72,9,27,12,120,high
10:00:00 AM,8,Wednesday,58,14,7,16,95,low
10:15:00 AM,8,Wednesday,80,9,26,10,125,high
10:30:00 AM,8,Wednesday,68,12,10,18,108,high
10:45:00 AM,8,Wednesday,57,8,13,32,110,high
11:00:00 AM,8,Wednesday,37,10,5,33,85,low
11:15:00 AM,8,Wednesday,59,0,1,26,86,low
11:30:00 AM,8,Wednesday,31,9,13,33,86,low
11:45:00 AM,8,Wednesday,54,8,9,30,101,high
12:00:00 PM,8,Wednesday,33,6,0,29,68,low
12:15:00 PM,8,Wednesday,65,0,13,28,106,high
12:30:00 PM,8,Wednesday,24,4,6,29,63,low
12:45:00 PM,8,Wednesday,46,10,12,29,97,low
01:00:00 PM,8,Wednesday,37,16,3,23,79,low
01:15:00 PM,8,Wednesday,42,16,26,17,101,high
01:30:00 PM,8,Wednesday,74,8,7,29,118,high
01:45:00 PM,8,Wednesday,43,12,21,11,87,low
02:00:00 PM,8,Wednesday,72,5,11,29,117,high
02:15:00 PM,8,Wednesday,62,14,22,19,117,high
02:30:00 PM,8,Wednesday,55,13,16,10,94,low
02:45:00 PM,8,Wednesday,97,9,15,26,147,high
03:00:00 PM,8,Wednesday,42,17,2,11,72,low
03:15:00 PM,8,Wednesday,16,14,14,18,62,low
03:30:00 PM,8,Wednesday,73,0,33,30,136,high
03:45:00 PM,8,Wednesday,106,5,29,14,154,high
04:00:00 PM,8,Wednesday,142,16,18,10,186,heavy
04:15:00 PM,8,Wednesday,112,8,21,17,158,heavy
04:30:00 PM,8,Wednesday,129,7,26,15,177,heavy
04:45:00 PM,8,Wednesday,131,11,10,18,170,heavy
05:00:00 PM,8,Wednesday,104,17,12,16,149,high
05:15:00 PM,8,Wednesday,128,19,32,20,199,heavy
05:30:00 PM,8,Wednesday,144,16,14,11,185,heavy
05:45:00 PM,8,Wednesday,150,5,11,18,184,heavy
06:00:00 PM,8,Wednesday,128,20,16,16,180,heavy
06:15:00 PM,8,Wednesday,104,28,12,11,155,heavy
06:30:00 PM,8,Wednesday,62,13,6,15,96,low
06:45:00 PM,8,Wednesday,66,16,17,35,134,high
07:00:00 PM,8,Wednesday,103,10,8,27,148,high
07:15:00 PM,8,Wednesday,63,0,10,18,91,low
07:30:00 PM,8,Wednesday,100,11,10,35,156,heavy
07:45:00 PM,8,Wednesday,70,1,7,20,98,low
08:00:00 PM,8,Wednesday,82,13,6,18,119,high
08:15:00 PM,8,Wednesday,98,16,17,33,164,heavy
08:30:00 PM,8,Wednesday,60,4,20,31,115,high
08:45:00 PM,8,Wednesday,90,18,15,23,146,high
09:00:00 PM,8,Wednesday,64,9,8,25,106,high
09:15:00 PM,8,Wednesday,82,14,11,18,125,high
09:30:00 PM,8,Wednesday,55,9,15,17,96,low
09:45:00 PM,8,Wednesday,7,1,2,24,34,normal
10:00:00 PM,8,Wednesday,11,0,1,28,40,normal
10:15:00 PM,8,Wednesday,9,1,1,20,31,normal
10:30:00 PM,8,Wednesday,15,0,2,40,57,normal
10:45:00 PM,8,Wednesday,12,1,1,24,38,normal
11:00:00 PM,8,Wednesday,8,0,1,32,41,normal
11:15:00 PM,8,Wednesday,7,2,0,36,45,normal
11:30:00 PM,8,Wednesday,8,1,2,36,47,normal
11:45:00 PM,8,Wednesday,6,2,0,23,31,normal
12:00:00 AM,9,Thursday,12,1,2,33,48,normal
12:15:00 AM,9,Thursday,9,0,1,25,35,normal
12:30:00 AM,9,Thursday,13,0,2,23,38,normal
12:45:00 AM,9,Thursday,15,2,0,28,45,normal
01:00:00 AM,9,Thursday,9,1,1,31,42,normal
01:15:00 AM,9,Thursday,10,1,1,32,44,normal
01:30:00 AM,9,Thursday,10,0,0,33,43,normal
01:45:00 AM,9,Thursday,12,1,0,35,48,normal
02:00:00 AM,9,Thursday,15,0,2,27,44,normal
02:15:00 AM,9,Thursday,13,1,2,34,50,normal
02:30:00 AM,9,Thursday,12,0,1,35,48,normal
02:45:00 AM,9,Thursday,13,2,0,28,43,normal
03:00:00 AM,9,Thursday,6,1,1,21,29,normal
03:15:00 AM,9,Thursday,12,1,0,27,40,normal
03:30:00 AM,9,Thursday,8,0,0,20,28,normal
03:45:00 AM,9,Thursday,8,2,2,35,47,normal
04:00:00 AM,9,Thursday,65,1,6,18,90,low
04:15:00 AM,9,Thursday,60,8,6,10,84,low
04:30:00 AM,9,Thursday,56,10,4,11,81,low
04:45:00 AM,9,Thursday,57,0,3,21,81,low
05:00:00 AM,9,Thursday,78,5,6,12,101,high
05:15:00 AM,9,Thursday,67,10,1,25,103,high
05:30:00 AM,9,Thursday,83,3,7,20,113,high
05:45:00 AM,9,Thursday,102,25,15,8,150,high
06:00:00 AM,9,Thursday,96,22,10,8,136,high
06:15:00 AM,9,Thursday,101,21,19,15,156,heavy
06:30:00 AM,9,Thursday,88,21,24,13,146,high
06:45:00 AM,9,Thursday,118,11,16,5,150,high
07:00:00 AM,9,Thursday,106,14,15,11,146,high
07:15:00 AM,9,Thursday,150,30,14,15,209,heavy
07:30:00 AM,9,Thursday,80,18,23,7,128,high
07:45:00 AM,9,Thursday,142,29,15,5,191,heavy
08:00:00 AM,9,Thursday,81,30,22,6,139,high
08:15:00 AM,9,Thursday,109,18,14,8,149,high
08:30:00 AM,9,Thursday,130,14,13,6,163,heavy
08:45:00 AM,9,Thursday,150,19,23,12,204,heavy
09:00:00 AM,9,Thursday,63,5,14,10,92,low
09:15:00 AM,9,Thursday,36,6,15,6,63,low
09:30:00 AM,9,Thursday,60,6,6,11,83,low
09:45:00 AM,9,Thursday,46,11,9,17,83,low
10:00:00 AM,9,Thursday,78,15,26,15,134,high
10:15:00 AM,9,Thursday,54,5,11,7,77,low
10:30:00 AM,9,Thursday,39,10,28,11,88,low
10:45:00 AM,9,Thursday,62,1,11,34,108,high
11:00:00 AM,9,Thursday,59,2,11,33,105,high
11:15:00 AM,9,Thursday,61,4,8,34,107,high
11:30:00 AM,9,Thursday,62,10,12,35,119,high
11:45:00 AM,9,Thursday,42,8,6,35,91,low
12:00:00 PM,9,Thursday,64,5,1,34,104,high
12:15:00 PM,9,Thursday,57,5,2,29,93,low
12:30:00 PM,9,Thursday,68,4,9,26,107,high
12:45:00 PM,9,Thursday,24,7,2,29,62,low
01:00:00 PM,9,Thursday,12,1,33,24,70,low
01:15:00 PM,9,Thursday,85,2,30,16,133,high
01:30:00 PM,9,Thursday,41,18,30,14,103,high
01:45:00 PM,9,Thursday,6,16,26,18,66,low
02:00:00 PM,9,Thursday,75,1,18,20,114,high
02:15:00 PM,9,Thursday,92,15,17,15,139,high
02:30:00 PM,9,Thursday,71,2,5,20,98,low
02:45:00 PM,9,Thursday,98,20,21,14,153,heavy
03:00:00 PM,9,Thursday,77,6,16,28,127,high
03:15:00 PM,9,Thursday,61,0,24,19,104,high
03:30:00 PM,9,Thursday,90,5,13,16,124,high
03:45:00 PM,9,Thursday,119,8,34,12,173,heavy
04:00:00 PM,9,Thursday,120,17,37,14,188,heavy
04:15:00 PM,9,Thursday,141,23,24,15,203,heavy
04:30:00 PM,9,Thursday,118,30,28,11,187,heavy
04:45:00 PM,9,Thursday,139,30,33,16,218,heavy
05:00:00 PM,9,Thursday,132,16,13,11,172,heavy
05:15:00 PM,9,Thursday,115,26,34,20,195,heavy
05:30:00 PM,9,Thursday,105,16,32,17,170,heavy
05:45:00 PM,9,Thursday,116,10,27,11,164,heavy
06:00:00 PM,9,Thursday,147,22,17,20,206,heavy
06:15:00 PM,9,Thursday,138,13,15,13,179,heavy
06:30:00 PM,9,Thursday,84,4,14,33,135,high
06:45:00 PM,9,Thursday,86,11,12,14,123,high
07:00:00 PM,9,Thursday,75,2,17,31,125,high
07:15:00 PM,9,Thursday,51,5,5,17,78,low
07:30:00 PM,9,Thursday,76,18,5,21,120,high
07:45:00 PM,9,Thursday,67,12,10,16,105,high
08:00:00 PM,9,Thursday,99,4,9,19,131,high
08:15:00 PM,9,Thursday,66,19,16,30,131,high
08:30:00 PM,9,Thursday,69,0,8,13,90,low
08:45:00 PM,9,Thursday,50,18,5,34,107,high
09:00:00 PM,9,Thursday,56,19,11,24,110,high
09:15:00 PM,9,Thursday,107,17,11,28,163,heavy
09:30:00 PM,9,Thursday,110,16,7,34,167,heavy
09:45:00 PM,9,Thursday,5,0,1,24,30,normal
10:00:00 PM,9,Thursday,6,0,1,36,43,normal
10:15:00 PM,9,Thursday,5,1,2,20,28,normal
10:30:00 PM,9,Thursday,6,2,1,28,37,normal
10:45:00 PM,9,Thursday,6,0,2,34,42,normal
11:00:00 PM,9,Thursday,5,0,2,24,31,normal
11:15:00 PM,9,Thursday,11,2,2,32,47,normal
11:30:00 PM,9,Thursday,5,2,2,37,46,normal
11:45:00 PM,9,Thursday,10,1,0,25,36,normal
12:00:00 AM,10,Tuesday,31,0,4,4,39,normal
12:15:00 AM,10,Tuesday,49,0,3,3,55,low
12:30:00 AM,10,Tuesday,46,0,3,6,55,low
12:45:00 AM,10,Tuesday,51,0,2,5,58,low
01:00:00 AM,10,Tuesday,57,6,15,16,94,low
01:15:00 AM,10,Tuesday,44,0,5,4,53,low
01:30:00 AM,10,Tuesday,37,0,1,4,42,normal
01:45:00 AM,10,Tuesday,42,4,4,5,55,low
02:00:00 AM,10,Tuesday,51,0,9,7,67,low
02:15:00 AM,10,Tuesday,34,0,4,7,45,normal
02:30:00 AM,10,Tuesday,45,0,1,1,47,normal
02:45:00 AM,10,Tuesday,45,0,1,3,49,normal
03:00:00 AM,10,Tuesday,50,0,3,0,53,low
03:15:00 AM,10,Tuesday,34,0,4,4,42,normal
03:30:00 AM,10,Tuesday,129,22,42,1,194,heavy
03:45:00 AM,10,Tuesday,144,16,49,0,209,heavy
04:00:00 AM,10,Tuesday,111,28,20,3,162,heavy
04:15:00 AM,10,Tuesday,67,11,10,16,104,high
04:30:00 AM,10,Tuesday,65,24,7,16,112,high
04:45:00 AM,10,Tuesday,94,27,7,16,144,high
05:00:00 AM,10,Tuesday,94,20,8,7,129,high
05:15:00 AM,10,Tuesday,67,29,5,10,111,high
05:30:00 AM,10,Tuesday,56,12,2,14,84,low
05:30:00 AM,10,Tuesday,56,12,2,14,84,low
05:45:00 AM,10,Tuesday,57,13,3,11,84,low
06:00:00 AM,10,Tuesday,129,22,42,1,194,heavy
06:15:00 AM,10,Tuesday,144,16,49,0,209,heavy
06:30:00 AM,10,Tuesday,111,28,20,3,162,heavy
06:45:00 AM,10,Tuesday,120,27,46,3,196,heavy
07:00:00 AM,10,Tuesday,102,39,47,1,189,heavy
07:15:00 AM,10,Tuesday,145,23,27,0,195,heavy
07:30:00 AM,10,Tuesday,114,37,21,5,177,heavy
07:45:00 AM,10,Tuesday,108,18,22,1,149,high
08:00:00 AM,10,Tuesday,122,28,33,1,184,heavy
08:15:00 AM,10,Tuesday,114,39,30,3,186,heavy
08:30:00 AM,10,Tuesday,150,36,25,1,212,heavy
08:45:00 AM,10,Tuesday,107,10,49,2,168,heavy
09:00:00 AM,10,Tuesday,124,24,22,0,170,heavy
09:15:00 AM,10,Tuesday,77,16,39,29,161,heavy
09:30:00 AM,10,Tuesday,15,23,30,21,89,low
09:45:00 AM,10,Tuesday,32,22,38,21,113,high
10:00:00 AM,10,Tuesday,68,13,29,24,134,high
10:15:00 AM,10,Tuesday,27,16,36,30,109,high
10:30:00 AM,10,Tuesday,76,7,11,15,109,high
10:45:00 AM,10,Tuesday,41,23,20,17,101,high
11:00:00 AM,10,Tuesday,33,10,3,29,75,low
11:15:00 AM,10,Tuesday,58,8,14,29,109,high
11:30:00 AM,10,Tuesday,65,7,11,26,109,high
11:45:00 AM,10,Tuesday,47,9,6,29,91,low
12:00:00 PM,10,Tuesday,38,10,5,25,78,low
12:15:00 PM,10,Tuesday,57,8,12,29,106,high
12:30:00 PM,10,Tuesday,20,6,4,20,50,normal
12:45:00 PM,10,Tuesday,24,9,14,23,70,low
01:00:00 PM,10,Tuesday,52,10,13,21,96,low
01:15:00 PM,10,Tuesday,79,15,36,18,148,high
01:30:00 PM,10,Tuesday,84,24,22,18,148,high
01:45:00 PM,10,Tuesday,59,19,35,16,129,high
02:00:00 PM,10,Tuesday,88,26,31,19,164,heavy
02:15:00 PM,10,Tuesday,24,11,32,13,80,low
02:30:00 PM,10,Tuesday,110,17,23,20,170,heavy
02:45:00 PM,10,Tuesday,29,26,5,6,66,low
03:00:00 PM,10,Tuesday,43,26,11,20,100,low
03:15:00 PM,10,Tuesday,68,28,9,15,120,high
03:30:00 PM,10,Tuesday,108,16,8,18,150,high
03:45:00 PM,10,Tuesday,101,26,8,14,149,high
04:00:00 PM,10,Tuesday,141,31,36,6,214,heavy
04:15:00 PM,10,Tuesday,120,25,28,5,178,heavy
04:30:00 PM,10,Tuesday,137,23,44,5,209,heavy
04:45:00 PM,10,Tuesday,124,11,30,7,172,heavy
05:00:00 PM,10,Tuesday,145,25,49,7,226,heavy
05:15:00 PM,10,Tuesday,122,37,23,8,190,heavy
05:30:00 PM,10,Tuesday,136,30,20,9,195,heavy
05:45:00 PM,10,Tuesday,145,18,40,9,212,heavy
06:00:00 PM,10,Tuesday,138,34,28,5,205,heavy
06:15:00 PM,10,Tuesday,123,10,29,8,170,heavy
06:30:00 PM,10,Tuesday,105,15,21,9,150,high
06:45:00 PM,10,Tuesday,75,22,20,11,128,high
07:00:00 PM,10,Tuesday,90,12,10,13,125,high
07:15:00 PM,10,Tuesday,102,22,20,16,160,heavy
07:30:00 PM,10,Tuesday,61,18,15,27,121,high
07:45:00 PM,10,Tuesday,70,8,14,6,98,low
08:00:00 PM,10,Tuesday,80,17,12,34,143,high
08:15:00 PM,10,Tuesday,62,12,14,19,107,high
08:30:00 PM,10,Tuesday,96,5,11,13,125,high
08:45:00 PM,10,Tuesday,102,6,12,13,133,normal
09:00:00 PM,10,Tuesday,91,14,15,6,126,normal
09:15:00 PM,10,Tuesday,95,8,17,13,133,normal
09:30:00 PM,10,Tuesday,75,15,12,21,123,normal
09:45:00 PM,10,Tuesday,53,21,20,10,104,high
10:00:00 PM,10,Tuesday,13,1,0,19,33,normal
10:15:00 PM,10,Tuesday,10,0,1,24,35,normal
10:30:00 PM,10,Tuesday,16,2,0,33,51,low
10:45:00 PM,10,Tuesday,11,1,0,29,41,normal
11:00:00 PM,10,Tuesday,18,2,1,13,34,normal
11:15:00 PM,10,Tuesday,15,0,1,11,27,normal
11:30:00 PM,10,Tuesday,14,1,0,33,48,normal
11:45:00 PM,10,Tuesday,17,2,0,22,41,normal
12:00:00 AM,11,Wednesday,12,2,1,17,32,normal
12:15:00 AM,11,Wednesday,18,0,0,29,47,normal
12:30:00 AM,11,Wednesday,16,1,0,14,31,normal
12:45:00 AM,11,Wednesday,20,0,0,14,34,normal
01:00:00 AM,11,Wednesday,20,1,1,30,52,low
01:15:00 AM,11,Wednesday,15,0,1,23,39,normal
01:30:00 AM,11,Wednesday,16,0,1,26,43,normal
01:45:00 AM,11,Wednesday,18,4,0,11,33,normal
02:00:00 AM,11,Wednesday,17,3,1,36,57,low
02:15:00 AM,11,Wednesday,14,4,1,10,29,normal
02:30:00 AM,11,Wednesday,18,2,1,25,46,normal
02:45:00 AM,11,Wednesday,12,2,0,19,33,normal
03:00:00 AM,11,Wednesday,11,4,0,30,45,normal
03:15:00 AM,11,Wednesday,19,1,1,36,57,low
03:30:00 AM,11,Wednesday,10,4,0,36,50,normal
03:45:00 AM,11,Wednesday,20,1,1,32,54,low
04:00:00 AM,11,Wednesday,15,5,1,40,61,low
04:15:00 AM,11,Wednesday,104,6,5,1,116,high
04:30:00 AM,11,Wednesday,109,25,3,8,145,high
04:45:00 AM,11,Wednesday,82,23,8,20,133,high
05:00:00 AM,11,Wednesday,81,25,1,18,125,high
05:15:00 AM,11,Wednesday,95,16,10,1,122,high
05:30:00 AM,11,Wednesday,91,24,7,6,128,high
05:45:00 AM,11,Wednesday,81,30,10,0,121,high
06:00:00 AM,11,Wednesday,125,13,26,2,166,heavy
06:15:00 AM,11,Wednesday,125,39,49,3,216,heavy
06:30:00 AM,11,Wednesday,125,34,37,1,197,heavy
06:45:00 AM,11,Wednesday,125,19,25,4,173,heavy
07:00:00 AM,11,Wednesday,125,15,49,0,189,heavy
07:15:00 AM,11,Wednesday,125,32,50,5,212,heavy
07:30:00 AM,11,Wednesday,125,38,50,1,214,heavy
07:45:00 AM,11,Wednesday,125,29,29,3,186,heavy
08:00:00 AM,11,Wednesday,125,31,48,4,208,heavy
08:15:00 AM,11,Wednesday,125,32,50,0,207,heavy
08:30:00 AM,11,Wednesday,125,31,45,0,201,heavy
08:45:00 AM,11,Wednesday,125,21,20,1,167,heavy
09:00:00 AM,11,Wednesday,125,28,36,0,189,heavy
09:15:00 AM,11,Wednesday,39,10,37,16,102,high
09:30:00 AM,11,Wednesday,89,8,12,13,122,high
09:45:00 AM,11,Wednesday,51,16,16,13,96,low
10:00:00 AM,11,Wednesday,17,9,18,28,72,low
10:15:00 AM,11,Wednesday,48,25,36,21,130,high
10:30:00 AM,11,Wednesday,93,7,30,16,146,high
10:45:00 AM,11,Wednesday,55,15,36,15,121,high
11:00:00 AM,11,Wednesday,51,10,8,22,91,low
11:15:00 AM,11,Wednesday,51,7,3,24,85,low
11:30:00 AM,11,Wednesday,51,9,7,30,97,low
11:45:00 AM,11,Wednesday,51,7,14,20,92,low
12:00:00 PM,11,Wednesday,51,10,14,20,95,low
12:15:00 PM,11,Wednesday,51,10,6,22,89,low
12:30:00 PM,11,Wednesday,51,8,11,22,92,low
12:45:00 PM,11,Wednesday,51,6,10,26,93,low
01:00:00 PM,11,Wednesday,51,7,7,27,92,low
01:15:00 PM,11,Wednesday,104,17,25,20,166,heavy
01:30:00 PM,11,Wednesday,6,28,27,14,75,low
01:45:00 PM,11,Wednesday,54,29,37,9,129,high
02:00:00 PM,11,Wednesday,43,13,30,20,106,high
02:15:00 PM,11,Wednesday,60,21,26,11,118,high
02:30:00 PM,11,Wednesday,101,23,8,20,152,heavy
02:45:00 PM,11,Wednesday,62,26,19,11,118,high
03:00:00 PM,11,Wednesday,39,24,13,11,87,low
03:15:00 PM,11,Wednesday,90,20,35,7,152,high
03:30:00 PM,11,Wednesday,109,30,22,20,181,heavy
03:45:00 PM,11,Wednesday,68,26,25,20,139,high
04:00:00 PM,11,Wednesday,142,22,37,6,207,heavy
04:15:00 PM,11,Wednesday,113,14,20,5,152,heavy
04:30:00 PM,11,Wednesday,142,13,37,8,200,heavy
04:45:00 PM,11,Wednesday,108,23,26,9,166,heavy
05:00:00 PM,11,Wednesday,122,29,30,7,188,heavy
05:15:00 PM,11,Wednesday,133,12,30,7,182,heavy
05:30:00 PM,11,Wednesday,118,23,38,10,189,heavy
05:45:00 PM,11,Wednesday,121,35,26,8,190,heavy
06:00:00 PM,11,Wednesday,116,23,20,8,167,heavy
06:15:00 PM,11,Wednesday,132,12,27,8,179,heavy
06:30:00 PM,11,Wednesday,144,17,33,7,201,heavy
06:45:00 PM,11,Wednesday,103,21,11,11,146,high
07:00:00 PM,11,Wednesday,107,15,10,15,147,high
07:15:00 PM,11,Wednesday,50,10,10,17,87,low
07:30:00 PM,11,Wednesday,108,15,10,6,139,high
07:45:00 PM,11,Wednesday,108,24,15,29,176,heavy
08:00:00 PM,11,Wednesday,101,6,15,13,135,high
08:15:00 PM,11,Wednesday,55,17,12,19,103,high
08:30:00 PM,11,Wednesday,77,7,20,16,120,high
08:45:00 PM,11,Wednesday,91,12,19,8,130,high
09:00:00 PM,11,Wednesday,95,25,17,29,166,heavy
09:15:00 PM,11,Wednesday,78,17,17,27,139,normal
09:30:00 PM,11,Wednesday,98,16,16,21,151,heavy
09:45:00 PM,11,Wednesday,86,13,11,35,145,high
10:00:00 PM,11,Wednesday,18,4,0,16,38,normal
10:15:00 PM,11,Wednesday,18,5,0,12,35,normal
10:30:00 PM,11,Wednesday,18,2,1,25,46,normal
10:45:00 PM,11,Wednesday,18,1,0,17,36,normal
11:00:00 PM,11,Wednesday,18,5,0,21,44,normal
11:15:00 PM,11,Wednesday,18,0,1,12,31,normal
11:30:00 PM,11,Wednesday,18,3,1,28,50,normal
11:45:00 PM,11,Wednesday,18,4,1,40,63,low
12:00:00 AM,12,Thursday,18,1,1,39,59,low
12:15:00 AM,12,Thursday,18,4,0,30,52,low
12:30:00 AM,12,Thursday,18,5,1,13,37,normal
12:45:00 AM,12,Thursday,18,2,0,37,57,low
01:00:00 AM,12,Thursday,18,0,0,13,31,normal
01:15:00 AM,12,Thursday,18,5,0,11,34,normal
01:30:00 AM,12,Thursday,18,5,1,12,36,normal
01:45:00 AM,12,Thursday,18,1,1,16,36,normal
02:00:00 AM,12,Thursday,18,1,1,34,54,low
02:15:00 AM,12,Thursday,18,1,0,24,43,normal
02:30:00 AM,12,Thursday,18,0,0,23,41,normal
02:45:00 AM,12,Thursday,18,0,0,27,45,normal
03:00:00 AM,12,Thursday,18,5,0,28,51,low
03:15:00 AM,12,Thursday,18,1,0,14,33,normal
03:30:00 AM,12,Thursday,18,5,0,25,48,normal
03:45:00 AM,12,Thursday,18,4,1,30,53,low
04:00:00 AM,12,Thursday,18,5,1,30,54,low
04:15:00 AM,12,Thursday,62,24,7,2,95,low
04:30:00 AM,12,Thursday,51,23,6,1,81,low
04:45:00 AM,12,Thursday,114,23,10,19,166,heavy
05:00:00 AM,12,Thursday,85,22,9,9,125,high
05:15:00 AM,12,Thursday,102,24,4,20,150,high
05:30:00 AM,12,Thursday,101,18,3,17,139,high
05:45:00 AM,12,Thursday,116,19,0,17,152,heavy
06:00:00 AM,12,Thursday,117,38,50,5,210,heavy
06:15:00 AM,12,Thursday,114,32,34,2,182,heavy
06:30:00 AM,12,Thursday,120,17,23,1,161,heavy
06:45:00 AM,12,Thursday,145,20,25,2,192,heavy
07:00:00 AM,12,Thursday,125,30,48,1,204,heavy
07:15:00 AM,12,Thursday,103,27,45,1,176,heavy
07:30:00 AM,12,Thursday,114,20,43,1,178,heavy
07:45:00 AM,12,Thursday,145,10,44,1,200,heavy
08:00:00 AM,12,Thursday,147,31,20,4,202,heavy
08:15:00 AM,12,Thursday,104,24,40,0,168,heavy
08:30:00 AM,12,Thursday,124,11,22,0,157,heavy
08:45:00 AM,12,Thursday,101,37,31,4,173,heavy
09:00:00 AM,12,Thursday,144,30,37,1,212,heavy
09:15:00 AM,12,Thursday,24,18,37,18,97,low
09:30:00 AM,12,Thursday,24,8,17,25,74,low
09:45:00 AM,12,Thursday,16,22,12,20,70,low
10:00:00 AM,12,Thursday,26,2,39,26,93,low
10:15:00 AM,12,Thursday,90,7,18,15,130,high
10:30:00 AM,12,Thursday,59,6,11,11,87,low
10:45:00 AM,12,Thursday,28,7,22,18,75,low
11:00:00 AM,12,Thursday,60,5,14,21,100,low
11:15:00 AM,12,Thursday,69,9,8,23,109,high
11:30:00 AM,12,Thursday,59,9,12,26,106,high
11:45:00 AM,12,Thursday,24,10,5,21,60,low
12:00:00 PM,12,Thursday,41,7,7,21,76,low
12:15:00 PM,12,Thursday,48,10,9,29,96,low
12:30:00 PM,12,Thursday,59,10,14,23,106,high
12:45:00 PM,12,Thursday,67,7,12,28,114,high
01:00:00 PM,12,Thursday,52,9,8,20,89,low
01:15:00 PM,12,Thursday,45,26,29,10,110,high
01:30:00 PM,12,Thursday,14,21,7,18,60,low
01:45:00 PM,12,Thursday,55,22,24,10,111,high
02:00:00 PM,12,Thursday,45,14,39,5,103,high
02:15:00 PM,12,Thursday,90,17,16,11,134,high
02:30:00 PM,12,Thursday,33,21,25,5,84,low
02:45:00 PM,12,Thursday,118,25,31,13,187,heavy
03:00:00 PM,12,Thursday,86,28,13,5,132,high
03:15:00 PM,12,Thursday,105,29,22,12,168,heavy
03:30:00 PM,12,Thursday,10,19,26,8,63,low
03:45:00 PM,12,Thursday,46,22,18,9,95,low
04:00:00 PM,12,Thursday,105,35,48,6,194,heavy
04:15:00 PM,12,Thursday,135,37,34,5,211,heavy
04:30:00 PM,12,Thursday,103,29,44,6,182,heavy
04:45:00 PM,12,Thursday,113,13,42,10,178,heavy
05:00:00 PM,12,Thursday,103,20,27,9,159,heavy
05:15:00 PM,12,Thursday,150,13,20,9,192,heavy
05:30:00 PM,12,Thursday,116,25,33,8,182,heavy
05:45:00 PM,12,Thursday,109,16,41,9,175,heavy
06:00:00 PM,12,Thursday,112,11,50,5,178,heavy
06:15:00 PM,12,Thursday,104,31,30,5,170,heavy
06:30:00 PM,12,Thursday,146,18,40,6,210,heavy
06:45:00 PM,12,Thursday,110,24,10,29,173,heavy
07:00:00 PM,12,Thursday,60,15,12,25,112,high
07:15:00 PM,12,Thursday,103,9,14,29,155,heavy
07:30:00 PM,12,Thursday,102,6,15,6,129,high
07:45:00 PM,12,Thursday,51,17,16,8,92,low
08:00:00 PM,12,Thursday,62,12,11,18,103,high
08:15:00 PM,12,Thursday,103,14,12,5,134,high
08:30:00 PM,12,Thursday,50,7,11,23,91,low
08:45:00 PM,12,Thursday,80,14,20,6,120,high
09:00:00 PM,12,Thursday,98,13,18,21,150,high
09:15:00 PM,12,Thursday,53,25,20,13,111,low
09:30:00 PM,12,Thursday,52,8,10,27,97,low
09:45:00 PM,12,Thursday,71,23,13,21,128,high
10:00:00 PM,12,Thursday,17,3,0,29,49,normal
10:15:00 PM,12,Thursday,20,5,1,36,62,low
10:30:00 PM,12,Thursday,15,0,0,32,47,normal
10:45:00 PM,12,Thursday,15,0,1,20,36,normal
11:00:00 PM,12,Thursday,14,2,0,23,39,normal
11:15:00 PM,12,Thursday,13,1,0,29,43,normal
11:30:00 PM,12,Thursday,14,5,0,31,50,normal
11:45:00 PM,12,Thursday,16,3,0,33,52,low
12:00:00 AM,13,Friday,18,4,1,15,38,normal
12:15:00 AM,13,Friday,20,0,1,23,44,normal
12:30:00 AM,13,Friday,19,3,0,16,38,normal
12:45:00 AM,13,Friday,10,3,0,12,25,normal
01:00:00 AM,13,Friday,10,4,0,23,37,normal
01:15:00 AM,13,Friday,12,5,0,29,46,normal
01:30:00 AM,13,Friday,10,0,0,39,49,normal
01:45:00 AM,13,Friday,16,2,1,21,40,normal
02:00:00 AM,13,Friday,18,4,1,36,59,low
02:15:00 AM,13,Friday,15,1,0,14,30,normal
02:30:00 AM,13,Friday,17,4,0,13,34,normal
02:45:00 AM,13,Friday,18,3,1,24,46,normal
03:00:00 AM,13,Friday,19,2,0,11,32,normal
03:15:00 AM,13,Friday,19,3,0,21,43,normal
03:30:00 AM,13,Friday,19,3,1,31,54,low
03:45:00 AM,13,Friday,14,2,1,19,36,normal
04:00:00 AM,13,Friday,11,0,0,27,38,normal
04:15:00 AM,13,Friday,27,6,1,11,45,normal
04:30:00 AM,13,Friday,33,11,6,13,63,low
04:45:00 AM,13,Friday,63,6,7,10,86,low
05:00:00 AM,13,Friday,58,13,4,15,90,low
05:15:00 AM,13,Friday,57,11,7,10,85,low
05:30:00 AM,13,Friday,63,10,6,12,91,low
05:45:00 AM,13,Friday,74,9,0,15,98,low
06:00:00 AM,13,Friday,71,9,7,10,97,low
06:15:00 AM,13,Friday,33,9,6,13,61,low
06:30:00 AM,13,Friday,29,6,1,12,48,normal
06:45:00 AM,13,Friday,32,9,3,11,55,low
07:00:00 AM,13,Friday,57,14,3,11,85,low
07:15:00 AM,13,Friday,31,11,0,14,56,low
07:30:00 AM,13,Friday,30,9,3,10,52,low
07:45:00 AM,13,Friday,61,8,7,12,88,low
08:00:00 AM,13,Friday,47,10,4,10,71,low
08:15:00 AM,13,Friday,80,16,4,15,115,high
08:30:00 AM,13,Friday,49,10,2,10,71,low
08:45:00 AM,13,Friday,58,7,5,13,83,low
09:00:00 AM,13,Friday,53,19,1,10,83,low
09:15:00 AM,13,Friday,132,47,25,0,204,heavy
09:30:00 AM,13,Friday,131,52,15,0,198,heavy
09:45:00 AM,13,Friday,171,59,27,3,260,heavy
10:00:00 AM,13,Friday,131,43,20,3,197,heavy
10:15:00 AM,13,Friday,177,56,12,4,249,heavy
10:30:00 AM,13,Friday,160,47,30,3,240,heavy
10:45:00 AM,13,Friday,178,68,28,4,278,heavy
11:00:00 AM,13,Friday,169,70,20,3,262,heavy
11:15:00 AM,13,Friday,133,56,25,2,216,heavy
11:30:00 AM,13,Friday,151,52,13,0,216,heavy
11:45:00 AM,13,Friday,179,46,27,3,255,heavy
12:00:00 PM,13,Friday,144,68,20,0,232,heavy
12:15:00 PM,13,Friday,162,46,19,2,229,heavy
12:30:00 PM,13,Friday,159,44,23,2,228,heavy
12:45:00 PM,13,Friday,174,67,30,1,272,heavy
01:00:00 PM,13,Friday,136,57,29,4,226,heavy
01:15:00 PM,13,Friday,156,42,12,3,213,heavy
01:30:00 PM,13,Friday,175,63,19,3,260,heavy
01:45:00 PM,13,Friday,172,62,20,2,256,heavy
02:00:00 PM,13,Friday,171,49,15,0,235,heavy
02:15:00 PM,13,Friday,172,65,18,2,257,heavy
02:30:00 PM,13,Friday,176,50,13,1,240,heavy
02:45:00 PM,13,Friday,153,50,23,3,229,heavy
03:00:00 PM,13,Friday,148,64,27,0,239,heavy
03:15:00 PM,13,Friday,56,28,6,2,92,low
03:30:00 PM,13,Friday,88,26,25,0,139,high
03:45:00 PM,13,Friday,82,23,14,0,119,high
04:00:00 PM,13,Friday,77,20,7,0,104,high
04:15:00 PM,13,Friday,66,24,1,0,91,low
04:30:00 PM,13,Friday,72,22,8,2,104,high
04:45:00 PM,13,Friday,62,28,21,2,113,high
05:00:00 PM,13,Friday,66,26,4,1,97,low
05:15:00 PM,13,Friday,85,20,4,0,109,high
05:30:00 PM,13,Friday,87,24,11,2,124,high
05:45:00 PM,13,Friday,67,28,25,0,120,high
06:00:00 PM,13,Friday,70,26,16,2,114,high
06:15:00 PM,13,Friday,62,20,20,1,103,high
06:30:00 PM,13,Friday,67,29,1,0,97,low
06:45:00 PM,13,Friday,65,25,1,1,92,low
07:00:00 PM,13,Friday,76,24,23,0,123,high
07:15:00 PM,13,Friday,42,1,5,11,59,low
07:30:00 PM,13,Friday,42,10,3,1,56,low
07:45:00 PM,13,Friday,31,11,1,12,55,low
08:00:00 PM,13,Friday,47,7,3,6,63,low
08:15:00 PM,13,Friday,28,7,2,4,41,normal
08:30:00 PM,13,Friday,22,3,6,1,32,normal
08:45:00 PM,13,Friday,29,1,7,5,42,normal
09:00:00 PM,13,Friday,43,9,1,11,64,low
09:15:00 PM,13,Friday,23,3,3,8,37,normal
09:30:00 PM,13,Friday,21,2,5,15,43,normal
09:45:00 PM,13,Friday,31,2,1,9,43,normal
10:00:00 PM,13,Friday,15,5,0,18,38,normal
10:15:00 PM,13,Friday,11,2,0,15,28,normal
10:30:00 PM,13,Friday,12,0,1,17,30,normal
10:45:00 PM,13,Friday,18,3,0,18,39,normal
11:00:00 PM,13,Friday,19,1,0,31,51,low
11:15:00 PM,13,Friday,17,0,0,22,39,normal
11:30:00 PM,13,Friday,15,5,0,14,34,normal
11:45:00 PM,13,Friday,15,1,1,24,41,normal
12:00:00 AM,14,Saturday,18,4,0,33,55,low
12:15:00 AM,14,Saturday,14,4,0,34,52,low
12:30:00 AM,14,Saturday,14,0,1,19,34,normal
12:45:00 AM,14,Saturday,19,3,0,36,58,low
01:00:00 AM,14,Saturday,10,4,1,21,36,normal
01:15:00 AM,14,Saturday,19,1,0,19,39,normal
01:30:00 AM,14,Saturday,18,5,0,26,49,normal
01:45:00 AM,14,Saturday,17,1,1,25,44,normal
02:00:00 AM,14,Saturday,20,2,0,12,34,normal
02:15:00 AM,14,Saturday,15,5,0,15,35,normal
02:30:00 AM,14,Saturday,11,4,0,14,29,normal
02:45:00 AM,14,Saturday,14,3,1,18,36,normal
03:00:00 AM,14,Saturday,13,2,0,39,54,low
03:15:00 AM,14,Saturday,17,5,0,29,51,low
03:30:00 AM,14,Saturday,13,5,0,31,49,normal
03:45:00 AM,14,Saturday,18,5,0,35,58,low
04:00:00 AM,14,Saturday,15,4,0,16,35,normal
04:15:00 AM,14,Saturday,55,15,5,3,78,low
04:30:00 AM,14,Saturday,76,10,7,9,102,high
04:45:00 AM,14,Saturday,98,0,9,19,126,high
05:00:00 AM,14,Saturday,98,12,6,6,122,high
05:15:00 AM,14,Saturday,103,2,10,20,135,high
05:30:00 AM,14,Saturday,93,17,8,12,130,high
05:45:00 AM,14,Saturday,115,27,9,16,167,heavy
06:00:00 AM,14,Saturday,120,12,22,3,157,heavy
06:15:00 AM,14,Saturday,142,18,27,0,187,heavy
06:30:00 AM,14,Saturday,117,29,49,2,197,heavy
06:45:00 AM,14,Saturday,126,36,24,0,186,heavy
07:00:00 AM,14,Saturday,110,39,38,5,192,heavy
07:15:00 AM,14,Saturday,149,20,39,5,213,heavy
07:30:00 AM,14,Saturday,109,29,23,5,166,heavy
07:45:00 AM,14,Saturday,124,34,24,4,186,heavy
08:00:00 AM,14,Saturday,149,35,32,1,217,heavy
08:15:00 AM,14,Saturday,125,32,38,4,199,heavy
08:30:00 AM,14,Saturday,101,23,38,1,163,heavy
08:45:00 AM,14,Saturday,137,36,30,0,203,heavy
09:00:00 AM,14,Saturday,139,15,21,3,178,heavy
09:15:00 AM,14,Saturday,19,3,29,9,60,low
09:30:00 AM,14,Saturday,13,11,39,7,70,low
09:45:00 AM,14,Saturday,31,2,29,27,89,low
10:00:00 AM,14,Saturday,18,24,21,22,85,low
10:15:00 AM,14,Saturday,26,12,14,13,65,low
10:30:00 AM,14,Saturday,31,15,13,28,87,low
10:45:00 AM,14,Saturday,12,22,8,11,53,low
11:00:00 AM,14,Saturday,54,5,13,23,95,low
11:15:00 AM,14,Saturday,59,7,13,21,100,low
11:30:00 AM,14,Saturday,58,8,6,23,95,low
11:45:00 AM,14,Saturday,53,8,9,25,95,low
12:00:00 PM,14,Saturday,54,7,7,20,88,low
12:15:00 PM,14,Saturday,39,10,4,29,82,low
12:30:00 PM,14,Saturday,38,9,8,22,77,low
12:45:00 PM,14,Saturday,36,5,10,23,74,low
01:00:00 PM,14,Saturday,68,6,12,24,110,high
01:15:00 PM,14,Saturday,50,18,26,14,108,high
01:30:00 PM,14,Saturday,120,28,22,20,190,heavy
01:45:00 PM,14,Saturday,60,14,28,9,111,high
02:00:00 PM,14,Saturday,105,14,8,19,146,high
02:15:00 PM,14,Saturday,89,27,18,8,142,high
02:30:00 PM,14,Saturday,28,17,31,10,86,low
02:45:00 PM,14,Saturday,79,14,23,6,122,high
03:00:00 PM,14,Saturday,15,11,30,14,70,low
03:15:00 PM,14,Saturday,77,27,23,18,145,high
03:30:00 PM,14,Saturday,19,14,24,6,63,low
03:45:00 PM,14,Saturday,79,13,28,7,127,high
04:00:00 PM,14,Saturday,114,10,22,9,155,heavy
04:15:00 PM,14,Saturday,150,30,22,5,207,heavy
04:30:00 PM,14,Saturday,142,23,25,7,197,heavy
04:45:00 PM,14,Saturday,111,36,25,6,178,heavy
05:00:00 PM,14,Saturday,143,37,38,8,226,heavy
05:15:00 PM,14,Saturday,120,37,43,10,210,heavy
05:30:00 PM,14,Saturday,147,20,49,7,223,heavy
05:45:00 PM,14,Saturday,140,22,27,5,194,heavy
06:00:00 PM,14,Saturday,128,37,20,9,194,heavy
06:15:00 PM,14,Saturday,114,23,42,10,189,heavy
06:30:00 PM,14,Saturday,117,20,22,9,168,heavy
06:45:00 PM,14,Saturday,93,24,17,23,157,heavy
07:00:00 PM,14,Saturday,65,15,15,8,103,high
07:15:00 PM,14,Saturday,100,22,14,8,144,high
07:30:00 PM,14,Saturday,85,12,11,18,126,high
07:45:00 PM,14,Saturday,56,7,12,12,87,low
08:00:00 PM,14,Saturday,50,12,15,18,95,low
08:15:00 PM,14,Saturday,74,9,11,12,106,high
08:30:00 PM,14,Saturday,73,15,18,7,113,high
08:45:00 PM,14,Saturday,99,13,20,30,162,heavy
09:00:00 PM,14,Saturday,110,14,17,8,149,high
09:15:00 PM,14,Saturday,82,5,12,34,133,high
09:30:00 PM,14,Saturday,58,19,12,17,106,high
09:45:00 PM,14,Saturday,70,10,14,32,126,high
10:00:00 PM,14,Saturday,10,1,0,33,44,normal
10:15:00 PM,14,Saturday,14,1,1,40,56,low
10:30:00 PM,14,Saturday,17,1,1,17,36,normal
10:45:00 PM,14,Saturday,12,4,1,22,39,normal
11:00:00 PM,14,Saturday,15,0,0,16,31,normal
11:15:00 PM,14,Saturday,13,4,0,25,42,normal
11:30:00 PM,14,Saturday,14,5,1,12,32,low
11:45:00 PM,14,Saturday,18,1,1,35,55,low
12:00:00 AM,15,Sunday,18,5,1,19,43,normal
12:15:00 AM,15,Sunday,19,3,0,38,60,low
12:30:00 AM,15,Sunday,13,0,1,12,26,low
12:45:00 AM,15,Sunday,20,0,1,38,59,low
01:00:00 AM,15,Sunday,20,1,1,24,46,normal
01:15:00 AM,15,Sunday,17,3,1,17,38,normal
01:30:00 AM,15,Sunday,12,3,1,35,51,low
01:45:00 AM,15,Sunday,19,0,1,30,50,normal
02:00:00 AM,15,Sunday,19,2,1,30,52,low
02:15:00 AM,15,Sunday,18,1,0,16,35,normal
02:30:00 AM,15,Sunday,11,0,0,31,42,normal
02:45:00 AM,15,Sunday,10,1,1,12,24,normal
03:00:00 AM,15,Sunday,16,1,0,24,41,normal
03:15:00 AM,15,Sunday,18,3,0,28,49,normal
03:30:00 AM,15,Sunday,20,1,1,39,61,low
03:45:00 AM,15,Sunday,19,3,1,27,50,normal
04:00:00 AM,15,Sunday,14,1,1,34,50,normal
04:15:00 AM,15,Sunday,61,26,1,16,104,high
04:30:00 AM,15,Sunday,72,26,6,4,108,high
04:45:00 AM,15,Sunday,86,24,3,18,131,high
05:00:00 AM,15,Sunday,75,1,8,10,94,low
05:15:00 AM,15,Sunday,75,1,7,9,92,low
05:30:00 AM,15,Sunday,93,5,4,1,103,high
05:45:00 AM,15,Sunday,111,6,2,5,124,high
06:00:00 AM,15,Sunday,111,18,41,2,172,heavy
06:15:00 AM,15,Sunday,114,27,46,0,187,heavy
06:30:00 AM,15,Sunday,139,19,50,2,210,heavy
06:45:00 AM,15,Sunday,109,14,38,1,162,heavy
07:00:00 AM,15,Sunday,105,16,22,3,146,high
07:15:00 AM,15,Sunday,150,13,31,4,198,heavy
07:30:00 AM,15,Sunday,122,13,47,3,185,heavy
07:45:00 AM,15,Sunday,114,24,46,2,186,heavy
08:00:00 AM,15,Sunday,119,36,41,0,196,heavy
08:15:00 AM,15,Sunday,108,35,39,0,182,heavy
08:30:00 AM,15,Sunday,113,18,28,1,160,heavy
08:45:00 AM,15,Sunday,118,36,37,0,191,heavy
09:00:00 AM,15,Sunday,113,35,48,3,199,heavy
09:15:00 AM,15,Sunday,66,7,22,30,125,high
09:30:00 AM,15,Sunday,64,12,27,8,111,high
09:45:00 AM,15,Sunday,37,5,13,11,66,low
10:00:00 AM,15,Sunday,82,17,31,20,150,high
10:15:00 AM,15,Sunday,63,5,23,12,103,high
10:30:00 AM,15,Sunday,20,12,16,24,72,low
10:45:00 AM,15,Sunday,46,5,34,9,94,low
11:00:00 AM,15,Sunday,35,9,8,29,81,low
11:15:00 AM,15,Sunday,33,9,11,21,74,low
11:30:00 AM,15,Sunday,32,9,10,30,81,low
11:45:00 AM,15,Sunday,62,10,6,22,100,low
12:00:00 PM,15,Sunday,62,10,11,22,105,high
12:15:00 PM,15,Sunday,54,10,12,25,101,high
12:30:00 PM,15,Sunday,48,8,15,23,94,low
12:45:00 PM,15,Sunday,20,10,12,24,66,low
01:00:00 PM,15,Sunday,35,10,5,30,80,low
01:15:00 PM,15,Sunday,112,15,40,10,177,heavy
01:30:00 PM,15,Sunday,51,21,25,13,110,high
01:45:00 PM,15,Sunday,53,12,23,8,96,low
02:00:00 PM,15,Sunday,63,22,18,15,118,high
02:15:00 PM,15,Sunday,50,23,16,8,97,low
02:30:00 PM,15,Sunday,94,20,35,17,166,heavy
02:45:00 PM,15,Sunday,7,27,39,17,90,low
03:00:00 PM,15,Sunday,109,18,13,6,146,high
03:15:00 PM,15,Sunday,18,27,19,6,70,low
03:30:00 PM,15,Sunday,21,30,5,5,61,low
03:45:00 PM,15,Sunday,49,16,9,12,86,low
04:00:00 PM,15,Sunday,129,28,40,6,203,heavy
04:15:00 PM,15,Sunday,141,18,28,8,195,heavy
04:30:00 PM,15,Sunday,131,14,43,7,195,heavy
04:45:00 PM,15,Sunday,105,38,23,5,171,heavy
05:00:00 PM,15,Sunday,125,35,37,5,202,heavy
05:15:00 PM,15,Sunday,127,36,42,9,214,heavy
05:30:00 PM,15,Sunday,129,22,25,9,185,heavy
05:45:00 PM,15,Sunday,121,39,47,8,215,heavy
06:00:00 PM,15,Sunday,138,29,42,9,218,heavy
06:15:00 PM,15,Sunday,119,26,21,5,171,heavy
06:30:00 PM,15,Sunday,138,17,48,8,211,heavy
06:45:00 PM,15,Sunday,72,12,14,32,130,high
07:00:00 PM,15,Sunday,92,23,20,30,165,heavy
07:15:00 PM,15,Sunday,94,17,11,24,146,high
07:30:00 PM,15,Sunday,102,25,12,24,163,heavy
07:45:00 PM,15,Sunday,71,23,17,14,125,high
08:00:00 PM,15,Sunday,58,5,19,25,107,high
08:15:00 PM,15,Sunday,93,22,18,10,143,high
08:30:00 PM,15,Sunday,59,23,10,35,127,high
08:45:00 PM,15,Sunday,57,20,10,20,107,high
09:00:00 PM,15,Sunday,96,9,18,25,148,high
09:15:00 PM,15,Sunday,104,12,16,20,152,heavy
09:30:00 PM,15,Sunday,104,22,17,23,166,heavy
09:45:00 PM,15,Sunday,88,8,11,29,136,high
10:00:00 PM,15,Sunday,20,3,0,16,39,normal
10:15:00 PM,15,Sunday,17,2,1,30,50,normal
10:30:00 PM,15,Sunday,17,4,0,23,44,normal
10:45:00 PM,15,Sunday,15,5,0,21,41,normal
11:00:00 PM,15,Sunday,10,0,1,31,42,normal
11:15:00 PM,15,Sunday,11,1,1,19,32,normal
11:30:00 PM,15,Sunday,12,2,0,29,43,normal
11:45:00 PM,15,Sunday,11,0,1,11,23,normal
12:00:00 AM,16,Monday,18,4,1,28,51,low
12:15:00 AM,16,Monday,13,3,0,26,42,normal
12:30:00 AM,16,Monday,16,3,0,34,53,low
12:45:00 AM,16,Monday,16,4,0,35,55,low
01:00:00 AM,16,Monday,20,2,1,33,56,low
01:15:00 AM,16,Monday,14,4,1,28,47,normal
01:30:00 AM,16,Monday,11,4,1,19,35,normal
01:45:00 AM,16,Monday,19,4,0,17,40,normal
02:00:00 AM,16,Monday,18,3,1,26,48,normal
02:15:00 AM,16,Monday,10,1,1,21,33,normal
02:30:00 AM,16,Monday,20,5,1,40,66,low
02:45:00 AM,16,Monday,11,5,0,37,53,low
03:00:00 AM,16,Monday,15,4,1,29,49,normal
03:15:00 AM,16,Monday,16,2,1,27,46,normal
03:30:00 AM,16,Monday,10,3,1,23,37,normal
03:45:00 AM,16,Monday,16,5,1,31,53,low
04:00:00 AM,16,Monday,20,0,1,30,51,low
04:15:00 AM,16,Monday,61,4,5,17,87,low
04:30:00 AM,16,Monday,91,8,6,2,107,high
04:45:00 AM,16,Monday,94,4,5,2,105,high
05:00:00 AM,16,Monday,117,8,6,16,147,high
05:15:00 AM,16,Monday,111,14,10,14,149,high
05:30:00 AM,16,Monday,91,2,3,5,101,high
05:45:00 AM,16,Monday,96,9,1,16,122,high
06:00:00 AM,16,Monday,134,15,42,5,196,heavy
06:15:00 AM,16,Monday,121,35,39,4,199,heavy
06:30:00 AM,16,Monday,118,40,40,3,201,heavy
06:45:00 AM,16,Monday,115,17,40,1,173,heavy
07:00:00 AM,16,Monday,106,22,37,0,165,heavy
07:15:00 AM,16,Monday,147,26,40,0,213,heavy
07:30:00 AM,16,Monday,102,13,31,2,148,high
07:45:00 AM,16,Monday,102,12,24,3,141,high
08:00:00 AM,16,Monday,130,40,31,2,203,heavy
08:15:00 AM,16,Monday,102,17,33,0,152,heavy
08:30:00 AM,16,Monday,105,13,48,5,171,heavy
08:45:00 AM,16,Monday,129,24,25,0,178,heavy
09:00:00 AM,16,Monday,117,11,45,0,173,heavy
09:15:00 AM,16,Monday,74,14,23,21,132,high
09:30:00 AM,16,Monday,80,14,35,18,147,high
09:45:00 AM,16,Monday,31,7,34,24,96,low
10:00:00 AM,16,Monday,18,15,9,15,57,low
10:15:00 AM,16,Monday,15,10,23,20,68,low
10:30:00 AM,16,Monday,37,18,8,16,79,low
10:45:00 AM,16,Monday,10,7,5,14,36,low
11:00:00 AM,16,Monday,54,6,15,23,98,low
11:15:00 AM,16,Monday,34,7,5,24,70,low
